,CustomerID,Recency,Frequency,MonetaryValue,Recency_Score,Frequency_Score,Monetary_Score,RFM_Score,RFM_Label
1,12413.0,66,37,676.15,1,2,1,4,Lost Customers
2,12426.0,194,29,510.73,1,5,2,8,Loyal Customers
3,12427.0,11,32,582.37,4,1,1,6,Potential Loyalists
4,12437.0,1,185,4392.66,5,1,1,7,Potential Loyalists
5,12441.0,366,10,155.55,1,5,3,9,Best Customers
6,12468.0,142,38,652.04,1,4,2,7,Potential Loyalists
7,12471.0,1,509,16358.92,5,1,1,7,Potential Loyalists
8,12472.0,30,384,5725.48,3,1,1,5,At Risk
9,12473.0,53,168,2555.77,1,2,1,4,Lost Customers
10,12474.0,16,441,6486.47,3,1,1,5,At Risk
11,12475.0,53,35,669.38,1,2,1,4,Lost Customers
12,12476.0,0,255,5628.58,5,1,1,7,Potential Loyalists
13,12477.0,22,308,13117.01,3,1,1,5,At Risk
14,12479.0,3,34,423.3,5,1,1,7,Potential Loyalists
15,12480.0,27,150,2885.63,3,1,1,5,At Risk
16,12481.0,22,210,5014.86,3,1,1,5,At Risk
17,12488.0,9,54,1244.66,4,1,1,6,Potential Loyalists
18,12489.0,335,14,298.93,1,5,3,9,Best Customers
19,12490.0,4,235,4859.93,5,1,1,7,Potential Loyalists
20,12491.0,38,25,424.40000000000003,2,1,1,4,Lost Customers
21,12492.0,62,18,227.21,1,2,1,4,Lost Customers
22,12493.0,165,22,398.79,1,5,2,8,Loyal Customers
23,12494.0,9,77,995.35,4,1,1,6,Potential Loyalists
24,12497.0,81,13,953.1,1,3,1,5,At Risk
25,12498.0,20,21,349.70000000000005,3,1,1,5,At Risk
26,12500.0,22,55,4026.27,3,1,1,5,At Risk
27,12501.0,314,159,1945.68,1,5,3,9,Best Customers
28,12504.0,17,14,59.99999999999999,3,1,1,5,At Risk
29,12506.0,232,23,73.5,1,5,2,8,Loyal Customers
30,12508.0,25,69,398.27,3,1,1,5,At Risk
31,12509.0,283,6,158.5,1,5,2,8,Loyal Customers
32,12513.0,84,35,532.79,1,3,1,5,At Risk
33,12516.0,77,24,1186.06,1,3,1,5,At Risk
34,12517.0,27,283,2284.89,3,1,1,5,At Risk
35,12518.0,0,119,1840.89,5,1,1,7,Potential Loyalists
36,12519.0,63,17,286.84000000000003,1,2,1,4,Lost Customers
37,12520.0,78,150,2294.5099999999998,1,3,1,5,At Risk
38,12521.0,142,37,545.68,1,4,2,7,Potential Loyalists
39,12522.0,38,10,156.72,2,1,1,4,Lost Customers
40,12523.0,1,106,1655.57,5,1,1,7,Potential Loyalists
41,12524.0,8,136,3945.72,4,1,1,6,Potential Loyalists
42,12526.0,0,68,1172.66,5,1,1,7,Potential Loyalists
43,12527.0,81,17,330.71000000000004,1,3,1,5,At Risk
44,12528.0,8,89,1634.28,4,1,1,6,Potential Loyalists
45,12530.0,59,64,1461.63,1,2,1,4,Lost Customers
46,12531.0,14,17,125.22,4,1,1,6,Potential Loyalists
47,12532.0,29,15,313.83000000000004,3,1,1,5,At Risk
48,12534.0,130,62,981.18,1,4,2,7,Potential Loyalists
49,12535.0,91,34,716.35,1,3,1,5,At Risk
50,12536.0,7,268,4151.26,5,1,1,7,Potential Loyalists
51,12553.0,7,187,3238.25,5,1,1,7,Potential Loyalists
52,12559.0,310,21,500.21000000000004,1,5,3,9,Best Customers
53,12560.0,4,109,1885.3899999999999,5,1,1,7,Potential Loyalists
54,12561.0,302,16,238.85,1,5,3,9,Best Customers
55,12562.0,7,161,3385.7400000000002,5,1,1,7,Potential Loyalists
56,12564.0,260,20,402.9,1,5,2,8,Loyal Customers
57,12566.0,72,19,292.7,1,2,1,4,Lost Customers
58,12567.0,22,455,8322.94,3,1,1,5,At Risk
59,12569.0,1,158,3128.9900000000002,5,1,1,7,Potential Loyalists
60,12571.0,39,34,519.61,2,1,1,4,Lost Customers
61,12572.0,8,60,896.72,4,1,1,6,Potential Loyalists
62,12573.0,226,28,160.54000000000002,1,5,2,8,Loyal Customers
63,12574.0,315,10,182.45000000000002,1,5,3,9,Best Customers
64,12577.0,34,147,591.45,2,1,1,4,Lost Customers
65,12579.0,72,29,374.72,1,2,1,4,Lost Customers
66,12580.0,246,23,379.7,1,5,2,8,Loyal Customers
67,12581.0,39,14,179.71,2,1,1,4,Lost Customers
68,12583.0,2,235,6629.34,5,1,1,7,Potential Loyalists
69,12585.0,233,95,1766.81,1,5,2,8,Loyal Customers
70,12589.0,28,33,574.68,3,1,1,5,At Risk
71,12590.0,189,69,9338.38,1,5,2,8,Loyal Customers
72,12592.0,91,16,401.6,1,3,1,5,At Risk
73,12593.0,108,20,382.09999999999997,1,4,2,7,Potential Loyalists
74,12598.0,9,128,2786.68,4,1,1,6,Potential Loyalists
75,12599.0,28,55,888.58,3,1,1,5,At Risk
76,12600.0,28,54,2311.04,3,1,1,5,At Risk
77,12601.0,189,24,479.56,1,5,2,8,Loyal Customers
78,12602.0,58,12,153.12,1,2,1,4,Lost Customers
79,12603.0,21,1,613.1999999999999,3,1,1,5,At Risk
80,12604.0,78,15,236.18,1,3,1,5,At Risk
82,12609.0,77,57,964.85,1,3,1,5,At Risk
83,12612.0,57,20,607.59,1,2,1,4,Lost Customers
84,12613.0,30,159,2966.98,3,1,1,5,At Risk
85,12614.0,277,20,315.6,1,5,2,8,Loyal Customers
86,12615.0,1,101,2093.19,5,1,1,7,Potential Loyalists
87,12616.0,84,34,585.25,1,3,1,5,At Risk
88,12617.0,28,42,355.53000000000003,3,1,1,5,At Risk
89,12619.0,15,86,2908.81,3,1,1,5,At Risk
90,12620.0,14,91,1303.41,4,1,1,6,Potential Loyalists
91,12621.0,1,456,12334.07,5,1,1,7,Potential Loyalists
92,12622.0,231,10,162.1,1,5,2,8,Loyal Customers
93,12623.0,275,17,269.1,1,5,2,8,Loyal Customers
94,12624.0,105,36,569.13,1,4,2,7,Potential Loyalists
95,12625.0,211,88,2362.32,1,5,2,8,Loyal Customers
96,12626.0,22,298,5722.35,3,1,1,5,At Risk
97,12627.0,10,224,4082.53,4,1,1,6,Potential Loyalists
98,12628.0,3,40,715.61,5,1,1,7,Potential Loyalists
99,12633.0,58,99,1906.63,1,2,1,4,Lost Customers
100,12635.0,89,99,1509.18,1,3,1,5,At Risk
101,12637.0,66,390,5809.25,1,2,1,4,Lost Customers
102,12640.0,23,50,994.58,3,1,1,5,At Risk
103,12642.0,24,44,905.26,3,1,1,5,At Risk
104,12643.0,127,18,3041.64,1,4,2,7,Potential Loyalists
105,12644.0,129,31,477.90999999999997,1,4,2,7,Potential Loyalists
106,12645.0,33,70,1611.38,2,1,1,4,Lost Customers
107,12647.0,21,116,3093.92,3,1,1,5,At Risk
108,12648.0,154,20,300.05,1,5,2,8,Loyal Customers
109,12649.0,106,31,549.71,1,4,2,7,Potential Loyalists
110,12650.0,2,19,242.44,5,1,1,7,Potential Loyalists
111,12651.0,334,9,114.0,1,5,3,9,Best Customers
112,12652.0,321,50,788.53,1,5,3,9,Best Customers
113,12654.0,10,34,529.98,4,1,1,6,Potential Loyalists
114,12656.0,16,125,3550.72,3,1,1,5,At Risk
115,12657.0,10,52,1008.06,4,1,1,6,Potential Loyalists
116,12658.0,18,35,632.05,3,1,1,5,At Risk
117,12659.0,29,4,73.67999999999999,3,1,1,5,At Risk
118,12660.0,10,12,227.1,4,1,1,6,Potential Loyalists
119,12662.0,0,222,3511.08,5,1,1,7,Potential Loyalists
120,12665.0,324,3,43.75,1,5,3,9,Best Customers
121,12668.0,6,164,3113.18,5,1,1,7,Potential Loyalists
122,12669.0,150,98,1427.73,1,5,2,8,Loyal Customers
123,12670.0,9,89,2734.15,4,1,1,6,Potential Loyalists
124,12672.0,329,10,225.9,1,5,3,9,Best Customers
125,12673.0,4,41,574.52,5,1,1,7,Potential Loyalists
126,12674.0,11,87,1793.31,4,1,1,6,Potential Loyalists
127,12678.0,41,159,16441.26,2,1,1,4,Lost Customers
128,12679.0,51,52,896.6700000000001,1,2,1,4,Lost Customers
129,12680.0,0,49,790.81,5,1,1,7,Potential Loyalists
130,12681.0,14,623,12309.59,4,1,1,6,Potential Loyalists
131,12682.0,3,496,11028.22,5,1,1,7,Potential Loyalists
132,12683.0,3,349,7357.09,5,1,1,7,Potential Loyalists
133,12684.0,7,98,2073.63,5,1,1,7,Potential Loyalists
134,12685.0,27,151,2575.08,3,1,1,5,At Risk
135,12686.0,371,6,71.14,1,5,3,9,Best Customers
136,12689.0,25,70,1139.61,3,1,1,5,At Risk
137,12690.0,205,15,335.01,1,5,2,8,Loyal Customers
138,12691.0,27,27,927.8,3,1,1,5,At Risk
139,12693.0,120,37,686.96,1,4,2,7,Potential Loyalists
140,12694.0,69,35,761.67,1,2,1,4,Lost Customers
141,12695.0,6,27,582.1,5,1,1,7,Potential Loyalists
142,12700.0,7,264,4525.99,5,1,1,7,Potential Loyalists
143,12701.0,79,51,725.71,1,3,1,5,At Risk
144,12702.0,19,11,201.0,3,1,1,5,At Risk
145,12703.0,63,21,256.7,1,2,1,4,Lost Customers
146,12705.0,14,342,6328.24,4,1,1,6,Potential Loyalists
147,12707.0,291,33,603.42,1,5,2,8,Loyal Customers
148,12708.0,29,164,2346.32,3,1,1,5,At Risk
149,12709.0,2,251,8989.75,5,1,1,7,Potential Loyalists
150,12710.0,96,76,1004.5699999999999,1,3,1,5,At Risk
151,12712.0,22,128,3791.63,3,1,1,5,At Risk
152,12713.0,0,37,794.55,5,1,1,7,Potential Loyalists
153,12714.0,8,254,4294.86,4,1,1,6,Potential Loyalists
154,12716.0,3,67,963.49,5,1,1,7,Potential Loyalists
155,12718.0,70,18,202.25,1,2,1,4,Lost Customers
156,12719.0,4,40,536.1,5,1,1,7,Potential Loyalists
157,12720.0,2,346,5065.28,5,1,1,7,Potential Loyalists
158,12721.0,31,158,2358.98,2,1,1,4,Lost Customers
159,12722.0,84,56,886.33,1,3,1,5,At Risk
160,12723.0,3,68,707.07,5,1,1,7,Potential Loyalists
161,12724.0,4,49,923.41,5,1,1,7,Potential Loyalists
162,12726.0,27,117,2411.1,3,1,1,5,At Risk
163,12727.0,10,133,3425.7,4,1,1,6,Potential Loyalists
164,12728.0,70,42,728.33,1,2,1,4,Lost Customers
165,12729.0,113,25,417.01,1,4,2,7,Potential Loyalists
166,12731.0,23,275,18660.41,3,1,1,5,At Risk
167,12732.0,179,11,218.26000000000002,1,5,2,8,Loyal Customers
168,12734.0,352,4,110.39999999999999,1,5,3,9,Best Customers
169,12735.0,314,41,689.5699999999999,1,5,3,9,Best Customers
170,12736.0,332,3,144.0,1,5,3,9,Best Customers
171,12738.0,371,10,137.35,1,5,3,9,Best Customers
172,12740.0,63,27,427.6,1,2,1,4,Lost Customers
173,12747.0,1,103,4196.01,5,1,1,7,Potential Loyalists
174,12748.0,0,4623,30486.53,5,1,1,7,Potential Loyalists
175,12749.0,3,231,3868.2,5,1,1,7,Potential Loyalists
176,12820.0,2,59,942.34,5,1,1,7,Potential Loyalists
177,12821.0,213,6,92.72,1,5,2,8,Loyal Customers
178,12822.0,70,47,918.98,1,2,1,4,Lost Customers
179,12823.0,74,5,1759.5,1,2,1,4,Lost Customers
180,12824.0,59,25,397.12,1,2,1,4,Lost Customers
181,12826.0,2,94,1468.1200000000001,5,1,1,7,Potential Loyalists
182,12827.0,5,25,430.15,5,1,1,7,Potential Loyalists
183,12828.0,2,56,1018.71,5,1,1,7,Potential Loyalists
184,12829.0,321,12,253.05,1,5,3,9,Best Customers
185,12830.0,37,38,6814.64,2,1,1,4,Lost Customers
186,12831.0,261,9,215.05,1,5,2,8,Loyal Customers
187,12832.0,31,27,383.03000000000003,2,1,1,4,Lost Customers
188,12833.0,144,24,417.38,1,4,2,7,Potential Loyalists
189,12834.0,282,18,312.38,1,5,2,8,Loyal Customers
190,12836.0,58,175,2612.86,1,2,1,4,Lost Customers
191,12837.0,172,12,134.1,1,5,2,8,Loyal Customers
192,12838.0,33,123,683.13,2,1,1,4,Lost Customers
193,12839.0,2,315,5588.12,5,1,1,7,Potential Loyalists
194,12840.0,143,116,2714.27,1,4,2,7,Potential Loyalists
195,12841.0,4,439,3876.4,5,1,1,7,Potential Loyalists
196,12842.0,69,34,1118.99,1,2,1,4,Lost Customers
197,12843.0,65,108,1680.76,1,2,1,4,Lost Customers
198,12844.0,28,52,325.96000000000004,3,1,1,5,At Risk
199,12845.0,266,27,354.09000000000003,1,5,2,8,Loyal Customers
200,12847.0,21,91,871.54,3,1,1,5,At Risk
201,12849.0,30,49,1033.25,3,1,1,5,At Risk
202,12851.0,96,50,135.18,1,3,1,5,At Risk
203,12852.0,289,20,299.75,1,5,2,8,Loyal Customers
204,12853.0,107,84,1881.7,1,4,2,7,Potential Loyalists
205,12854.0,78,115,1289.15,1,3,1,5,At Risk
206,12855.0,372,3,38.1,1,5,3,9,Best Customers
207,12856.0,7,317,2162.68,5,1,1,7,Potential Loyalists
208,12857.0,210,46,1106.4,1,5,2,8,Loyal Customers
209,12863.0,51,6,504.2,1,2,1,4,Lost Customers
210,12864.0,137,3,147.12,1,4,2,7,Potential Loyalists
211,12867.0,25,550,3990.47,3,1,1,5,At Risk
212,12868.0,185,107,1607.0600000000002,1,5,2,8,Loyal Customers
214,12871.0,83,11,380.64,1,3,1,5,At Risk
215,12872.0,326,66,599.97,1,5,3,9,Best Customers
216,12873.0,281,4,374.0,1,5,2,8,Loyal Customers
217,12875.0,142,2,343.2300000000001,1,4,2,7,Potential Loyalists
218,12877.0,3,154,1535.77,5,1,1,7,Potential Loyalists
219,12878.0,17,49,841.64,3,1,1,5,At Risk
220,12879.0,44,12,552.57,2,2,1,5,At Risk
221,12881.0,275,7,298.0,1,5,2,8,Loyal Customers
222,12882.0,8,13,1463.04,4,1,1,6,Potential Loyalists
223,12883.0,24,42,703.47,3,1,1,5,At Risk
224,12884.0,87,7,309.05,1,3,1,5,At Risk
225,12885.0,62,72,1158.27,1,2,1,4,Lost Customers
226,12886.0,67,86,1351.09,1,2,1,4,Lost Customers
227,12888.0,213,7,313.77,1,5,2,8,Loyal Customers
228,12890.0,23,82,380.46999999999997,3,1,1,5,At Risk
229,12891.0,185,3,331.0,1,5,2,8,Loyal Customers
230,12893.0,30,34,188.14,3,1,1,5,At Risk
231,12895.0,41,24,347.3,2,1,1,4,Lost Customers
232,12897.0,204,4,216.5,1,5,2,8,Loyal Customers
233,12901.0,8,123,16316.14,4,1,1,6,Potential Loyalists
234,12902.0,264,10,138.68,1,5,2,8,Loyal Customers
235,12904.0,17,72,509.58,3,1,1,5,At Risk
236,12906.0,11,63,2919.81,4,1,1,6,Potential Loyalists
237,12908.0,175,3,360.0,1,5,2,8,Loyal Customers
238,12909.0,39,96,2128.83,2,1,1,4,Lost Customers
239,12910.0,22,75,3075.04,3,1,1,5,At Risk
240,12912.0,2,24,1662.3,5,1,1,7,Potential Loyalists
241,12913.0,4,50,2483.63,5,1,1,7,Potential Loyalists
242,12915.0,148,22,363.65,1,4,2,7,Potential Loyalists
243,12916.0,138,109,2982.35,1,4,2,7,Potential Loyalists
244,12917.0,127,2,594.0,1,4,2,7,Potential Loyalists
245,12919.0,7,52,1301.44,5,1,1,7,Potential Loyalists
246,12920.0,16,28,164.23,3,1,1,5,At Risk
247,12921.0,3,741,16389.74,5,1,1,7,Potential Loyalists
248,12922.0,160,28,405.38,1,5,2,8,Loyal Customers
249,12923.0,63,28,175.72,1,2,1,4,Lost Customers
250,12924.0,87,30,922.0,1,3,1,5,At Risk
251,12925.0,4,45,694.05,5,1,1,7,Potential Loyalists
252,12928.0,34,84,2062.7,2,1,1,4,Lost Customers
253,12929.0,121,9,105.1,1,4,2,7,Potential Loyalists
254,12930.0,77,27,409.90000000000003,1,3,1,5,At Risk
255,12931.0,21,101,33544.81,3,1,1,5,At Risk
256,12933.0,23,107,606.28,3,1,1,5,At Risk
257,12935.0,1,130,2156.45,5,1,1,7,Potential Loyalists
258,12936.0,16,63,1012.9,3,1,1,5,At Risk
259,12937.0,14,120,1504.27,4,1,1,6,Potential Loyalists
260,12938.0,25,9,114.14,3,1,1,5,At Risk
261,12939.0,63,47,11581.8,1,2,1,4,Lost Customers
262,12940.0,45,103,876.29,2,2,1,5,At Risk
263,12942.0,130,75,683.9,1,4,2,7,Potential Loyalists
265,12944.0,35,30,604.51,2,1,1,4,Lost Customers
266,12945.0,287,23,462.95,1,5,2,8,Loyal Customers
267,12947.0,143,103,1407.29,1,4,2,7,Potential Loyalists
268,12948.0,15,118,2053.7,3,1,1,5,At Risk
269,12949.0,30,219,4143.02,3,1,1,5,At Risk
270,12950.0,1,23,1843.0,5,1,1,7,Potential Loyalists
271,12951.0,8,65,1042.07,4,1,1,6,Potential Loyalists
272,12952.0,5,80,1382.84,5,1,1,7,Potential Loyalists
273,12953.0,9,17,329.85,4,1,1,6,Potential Loyalists
274,12955.0,0,183,4734.26,5,1,1,7,Potential Loyalists
275,12956.0,305,19,108.07,1,5,3,9,Best Customers
276,12957.0,3,244,3979.04,5,1,1,7,Potential Loyalists
277,12962.0,6,16,266.39,5,1,1,7,Potential Loyalists
278,12963.0,7,95,1856.63,5,1,1,7,Potential Loyalists
279,12965.0,88,109,771.91,1,3,1,5,At Risk
280,12966.0,9,10,160.18,4,1,1,6,Potential Loyalists
281,12967.0,2,33,1194.75,5,1,1,7,Potential Loyalists
282,12968.0,111,5,135.95,1,4,2,7,Potential Loyalists
283,12970.0,6,151,452.24,5,1,1,7,Potential Loyalists
284,12971.0,3,307,10933.76,5,1,1,7,Potential Loyalists
285,12974.0,197,8,144.8,1,5,2,8,Loyal Customers
286,12976.0,211,22,738.6,1,5,2,8,Loyal Customers
287,12977.0,155,9,39.239999999999995,1,5,2,8,Loyal Customers
288,12980.0,155,24,7092.06,1,5,2,8,Loyal Customers
289,12981.0,29,20,372.21999999999997,3,1,1,5,At Risk
290,12982.0,239,34,377.2,1,5,2,8,Loyal Customers
291,12984.0,18,4,97.5,3,1,1,5,At Risk
292,12985.0,0,78,1215.6200000000001,5,1,1,7,Potential Loyalists
293,12987.0,73,30,545.0,1,2,1,4,Lost Customers
294,12988.0,291,92,535.32,1,5,2,8,Loyal Customers
295,12989.0,2,68,6854.51,5,1,1,7,Potential Loyalists
296,12990.0,30,13,409.5,3,1,1,5,At Risk
297,12991.0,22,31,503.76,3,1,1,5,At Risk
298,12993.0,22,27,414.76,3,1,1,5,At Risk
299,12994.0,3,73,902.22,5,1,1,7,Potential Loyalists
300,12995.0,77,5,200.72,1,3,1,5,At Risk
301,12997.0,21,67,1197.94,3,1,1,5,At Risk
302,12999.0,195,28,455.88,1,5,2,8,Loyal Customers
303,13000.0,106,31,534.85,1,4,2,7,Potential Loyalists
304,13001.0,3,342,9797.92,5,1,1,7,Potential Loyalists
305,13002.0,317,7,120.94999999999999,1,5,3,9,Best Customers
306,13003.0,105,6,149.05,1,4,2,7,Potential Loyalists
307,13004.0,11,409,5613.43,4,1,1,6,Potential Loyalists
308,13005.0,173,29,468.95,1,5,2,8,Loyal Customers
309,13006.0,55,4,81.57,1,2,1,4,Lost Customers
310,13008.0,322,15,178.46999999999997,1,5,3,9,Best Customers
311,13011.0,371,3,50.550000000000004,1,5,3,9,Best Customers
312,13012.0,8,106,1316.72,4,1,1,6,Potential Loyalists
313,13013.0,0,222,4786.99,5,1,1,7,Potential Loyalists
314,13014.0,2,124,3365.43,5,1,1,7,Potential Loyalists
315,13015.0,52,176,3346.28,1,2,1,4,Lost Customers
316,13016.0,72,47,789.89,1,2,1,4,Lost Customers
317,13017.0,6,1,204.0,5,1,1,7,Potential Loyalists
318,13018.0,15,459,7272.75,3,1,1,5,At Risk
319,13021.0,3,134,2584.4,5,1,1,7,Potential Loyalists
320,13023.0,63,38,599.9,1,2,1,4,Lost Customers
321,13026.0,0,42,943.77,5,1,1,7,Potential Loyalists
322,13027.0,113,26,6912.0,1,4,2,7,Potential Loyalists
323,13028.0,22,47,659.68,3,1,1,5,At Risk
324,13029.0,30,10,1247.5,3,1,1,5,At Risk
325,13030.0,10,99,799.48,4,1,1,6,Potential Loyalists
326,13032.0,38,75,996.52,2,1,1,4,Lost Customers
327,13033.0,356,11,190.55,1,5,3,9,Best Customers
328,13034.0,54,37,642.77,1,2,1,4,Lost Customers
329,13035.0,57,30,886.63,1,2,1,4,Lost Customers
330,13037.0,137,48,881.07,1,4,2,7,Potential Loyalists
331,13038.0,79,28,908.46,1,3,1,5,At Risk
332,13040.0,8,43,676.99,4,1,1,6,Potential Loyalists
333,13043.0,253,14,471.57,1,5,2,8,Loyal Customers
334,13044.0,290,33,560.47,1,5,2,8,Loyal Customers
335,13045.0,98,18,305.28,1,3,1,5,At Risk
336,13046.0,30,35,629.31,3,1,1,5,At Risk
337,13047.0,45,194,3089.1,2,2,1,5,At Risk
338,13048.0,13,137,1805.91,4,1,1,6,Potential Loyalists
339,13049.0,63,14,656.6800000000001,1,2,1,4,Lost Customers
340,13050.0,8,421,5680.86,4,1,1,6,Potential Loyalists
341,13052.0,211,18,348.15000000000003,1,5,2,8,Loyal Customers
342,13055.0,63,78,1201.96,1,2,1,4,Lost Customers
343,13058.0,24,8,271.40000000000003,3,1,1,5,At Risk
344,13059.0,249,8,183.4,1,5,2,8,Loyal Customers
345,13060.0,253,15,307.53000000000003,1,5,2,8,Loyal Customers
346,13061.0,71,10,248.61,1,2,1,4,Lost Customers
347,13062.0,190,11,346.98,1,5,2,8,Loyal Customers
348,13064.0,12,69,1119.49,4,1,1,6,Potential Loyalists
349,13065.0,372,14,205.86,1,5,3,9,Best Customers
350,13066.0,23,49,430.9,3,1,1,5,At Risk
351,13067.0,81,15,115.46000000000001,1,3,1,5,At Risk
352,13068.0,9,2,344.0,4,1,1,6,Potential Loyalists
353,13069.0,0,470,3717.82,5,1,1,7,Potential Loyalists
354,13070.0,191,9,228.8,1,5,2,8,Loyal Customers
355,13072.0,266,7,177.15,1,5,2,8,Loyal Customers
356,13075.0,129,22,919.61,1,4,2,7,Potential Loyalists
357,13077.0,0,112,729.27,5,1,1,7,Potential Loyalists
358,13078.0,0,380,12432.28,5,1,1,7,Potential Loyalists
359,13079.0,3,6,220.10000000000002,5,1,1,7,Potential Loyalists
360,13080.0,178,6,58.08,1,5,2,8,Loyal Customers
361,13081.0,0,1060,27972.08,5,1,1,7,Potential Loyalists
362,13082.0,125,75,3595.48,1,4,2,7,Potential Loyalists
363,13083.0,3,18,303.75,5,1,1,7,Potential Loyalists
364,13085.0,157,29,272.38,1,5,2,8,Loyal Customers
365,13089.0,2,1857,57385.88,5,1,1,7,Potential Loyalists
366,13090.0,8,160,8674.39,4,1,1,6,Potential Loyalists
367,13091.0,20,24,319.82,3,1,1,5,At Risk
368,13092.0,70,26,459.83,1,2,1,4,Lost Customers
369,13093.0,266,170,7741.47,1,5,2,8,Loyal Customers
370,13094.0,20,30,1708.8600000000001,3,1,1,5,At Risk
371,13095.0,70,6,74.39999999999999,1,2,1,4,Lost Customers
372,13097.0,32,436,5908.27,2,1,1,4,Lost Customers
373,13098.0,0,605,28658.88,5,1,1,7,Potential Loyalists
374,13099.0,98,1,207.36,1,3,1,5,At Risk
375,13101.0,233,8,101.19,1,5,2,8,Loyal Customers
376,13102.0,0,310,6336.29,5,1,1,7,Potential Loyalists
377,13103.0,39,8,243.94,2,1,1,4,Lost Customers
378,13104.0,2,20,1098.48,5,1,1,7,Potential Loyalists
379,13106.0,128,2,59.5,1,4,2,7,Potential Loyalists
380,13107.0,43,60,1524.07,2,2,1,5,At Risk
381,13108.0,372,10,350.06,1,5,3,9,Best Customers
382,13109.0,2,50,766.84,5,1,1,7,Potential Loyalists
383,13110.0,30,146,1452.8700000000001,3,1,1,5,At Risk
384,13113.0,0,279,10523.65,5,1,1,7,Potential Loyalists
385,13115.0,8,132,2205.63,4,1,1,6,Potential Loyalists
386,13116.0,116,31,485.19,1,4,2,7,Potential Loyalists
387,13117.0,21,76,984.91,3,1,1,5,At Risk
388,13118.0,19,82,1125.0,3,1,1,5,At Risk
389,13120.0,238,1,30.6,1,5,2,8,Loyal Customers
390,13121.0,268,53,254.73,1,5,2,8,Loyal Customers
391,13122.0,93,55,922.39,1,3,1,5,At Risk
392,13124.0,89,235,3866.33,1,3,1,5,At Risk
393,13126.0,4,142,2056.29,5,1,1,7,Potential Loyalists
394,13127.0,77,15,259.17,1,3,1,5,At Risk
395,13130.0,93,2,64.0,1,3,1,5,At Risk
396,13131.0,22,46,1039.3,3,1,1,5,At Risk
397,13132.0,261,3,77.3,1,5,2,8,Loyal Customers
398,13133.0,273,7,109.8,1,5,2,8,Loyal Customers
399,13134.0,72,105,1740.63,1,2,1,4,Lost Customers
400,13135.0,196,1,3096.0,1,5,2,8,Loyal Customers
401,13136.0,49,139,2545.38,1,2,1,4,Lost Customers
402,13137.0,10,704,3650.41,4,1,1,6,Potential Loyalists
403,13138.0,21,63,962.39,3,1,1,5,At Risk
404,13139.0,15,174,5055.79,3,1,1,5,At Risk
405,13140.0,107,46,423.72,1,4,2,7,Potential Loyalists
406,13141.0,84,136,2385.8,1,3,1,5,At Risk
407,13142.0,18,23,307.09000000000003,3,1,1,5,At Risk
408,13144.0,332,3,110.95,1,5,3,9,Best Customers
409,13145.0,39,7,614.77,2,1,1,4,Lost Customers
410,13146.0,25,17,228.91,3,1,1,5,At Risk
411,13147.0,9,4,712.8,4,1,1,6,Potential Loyalists
412,13148.0,28,347,3348.48,3,1,1,5,At Risk
413,13149.0,13,86,1676.06,4,1,1,6,Potential Loyalists
414,13151.0,202,75,1250.3700000000001,1,5,2,8,Loyal Customers
415,13153.0,5,15,486.22,5,1,1,7,Potential Loyalists
416,13155.0,32,85,971.76,2,1,1,4,Lost Customers
417,13157.0,48,89,1721.57,1,2,1,4,Lost Customers
418,13158.0,94,79,1201.06,1,3,1,5,At Risk
419,13159.0,8,122,1379.75,4,1,1,6,Potential Loyalists
420,13160.0,21,4,91.8,3,1,1,5,At Risk
421,13161.0,312,8,112.75,1,5,3,9,Best Customers
422,13162.0,121,82,1644.99,1,4,2,7,Potential Loyalists
423,13165.0,45,42,1021.48,2,2,1,5,At Risk
424,13166.0,281,42,414.7,1,5,2,8,Loyal Customers
425,13167.0,18,64,779.33,3,1,1,5,At Risk
426,13168.0,35,133,1310.14,2,1,1,4,Lost Customers
427,13169.0,63,13,712.88,1,2,1,4,Lost Customers
428,13170.0,26,32,116.00999999999999,3,1,1,5,At Risk
429,13171.0,7,48,426.81,5,1,1,7,Potential Loyalists
430,13173.0,3,43,353.65000000000003,5,1,1,7,Potential Loyalists
431,13174.0,15,313,2813.03,3,1,1,5,At Risk
432,13176.0,45,72,492.84,2,2,1,5,At Risk
433,13177.0,64,17,282.45,1,2,1,4,Lost Customers
434,13178.0,25,265,5725.47,3,1,1,5,At Risk
435,13182.0,44,11,121.18,2,2,1,5,At Risk
436,13183.0,7,94,3957.78,5,1,1,7,Potential Loyalists
437,13184.0,14,182,1647.79,4,1,1,6,Potential Loyalists
438,13185.0,267,1,71.4,1,5,2,8,Loyal Customers
439,13186.0,39,84,1539.69,2,1,1,4,Lost Customers
440,13187.0,336,37,236.02,1,5,3,9,Best Customers
441,13188.0,10,2,114.6,4,1,1,6,Potential Loyalists
442,13189.0,18,29,260.68,3,1,1,5,At Risk
443,13192.0,94,63,911.94,1,3,1,5,At Risk
444,13193.0,60,29,117.88,1,2,1,4,Lost Customers
445,13194.0,135,3,60.7,1,4,2,7,Potential Loyalists
446,13196.0,10,110,1797.78,4,1,1,6,Potential Loyalists
447,13198.0,9,229,3384.09,4,1,1,6,Potential Loyalists
448,13199.0,3,119,9788.96,5,1,1,7,Potential Loyalists
449,13200.0,18,46,870.09,3,1,1,5,At Risk
450,13203.0,9,57,869.46,4,1,1,6,Potential Loyalists
451,13207.0,14,8,250.26000000000002,4,1,1,6,Potential Loyalists
452,13208.0,58,147,1199.42,1,2,1,4,Lost Customers
453,13209.0,29,329,5820.16,3,1,1,5,At Risk
454,13210.0,93,22,353.48,1,3,1,5,At Risk
455,13211.0,9,56,1197.42,4,1,1,6,Potential Loyalists
456,13212.0,8,143,780.58,4,1,1,6,Potential Loyalists
457,13213.0,56,92,1518.43,1,2,1,4,Lost Customers
458,13216.0,267,5,333.74,1,5,2,8,Loyal Customers
459,13217.0,121,7,133.62,1,4,2,7,Potential Loyalists
460,13218.0,126,5,62.63999999999999,1,4,2,7,Potential Loyalists
461,13220.0,77,21,819.2900000000001,1,3,1,5,At Risk
462,13221.0,239,65,844.86,1,5,2,8,Loyal Customers
463,13223.0,199,5,163.2,1,5,2,8,Loyal Customers
464,13224.0,59,108,2147.85,1,2,1,4,Lost Customers
465,13225.0,2,34,6083.04,5,1,1,7,Potential Loyalists
466,13226.0,272,16,108.21000000000001,1,5,2,8,Loyal Customers
467,13227.0,201,9,257.7,1,5,2,8,Loyal Customers
468,13228.0,80,2,358.0,1,3,1,5,At Risk
469,13229.0,225,10,160.95,1,5,2,8,Loyal Customers
470,13230.0,3,612,2763.41,5,1,1,7,Potential Loyalists
471,13232.0,12,206,1357.0,4,1,1,6,Potential Loyalists
472,13233.0,73,43,605.12,1,2,1,4,Lost Customers
473,13235.0,211,58,1031.07,1,5,2,8,Loyal Customers
474,13236.0,24,39,727.27,3,1,1,5,At Risk
475,13238.0,10,32,680.83,4,1,1,6,Potential Loyalists
476,13239.0,261,22,329.56,1,5,2,8,Loyal Customers
477,13240.0,95,66,648.7,1,3,1,5,At Risk
478,13242.0,111,13,270.40000000000003,1,4,2,7,Potential Loyalists
479,13243.0,202,58,600.07,1,5,2,8,Loyal Customers
480,13244.0,92,27,121.74000000000001,1,3,1,5,At Risk
481,13245.0,50,16,430.5,1,2,1,4,Lost Customers
482,13246.0,17,143,1922.1,3,1,1,5,At Risk
483,13247.0,17,25,501.12,3,1,1,5,At Risk
484,13248.0,124,26,465.68,1,4,2,7,Potential Loyalists
485,13249.0,91,23,711.41,1,3,1,5,At Risk
486,13253.0,156,36,1030.4,1,5,2,8,Loyal Customers
487,13255.0,3,14,390.65999999999997,5,1,1,7,Potential Loyalists
489,13258.0,11,38,698.5799999999999,4,1,1,6,Potential Loyalists
490,13259.0,61,87,292.32,1,2,1,4,Lost Customers
491,13260.0,60,8,557.62,1,2,1,4,Lost Customers
492,13261.0,268,9,944.1,1,5,2,8,Loyal Customers
493,13262.0,262,11,200.29,1,5,2,8,Loyal Customers
494,13263.0,0,1672,7428.85,5,1,1,7,Potential Loyalists
495,13265.0,52,91,2107.66,1,2,1,4,Lost Customers
496,13266.0,10,202,3717.67,4,1,1,6,Potential Loyalists
497,13267.0,2,224,4404.4400000000005,5,1,1,7,Potential Loyalists
498,13268.0,17,446,3145.6,3,1,1,5,At Risk
499,13269.0,0,320,5315.92,5,1,1,7,Potential Loyalists
500,13270.0,365,1,590.0,1,5,3,9,Best Customers
501,13271.0,36,101,178.26,2,1,1,4,Lost Customers
502,13272.0,30,15,276.56,3,1,1,5,At Risk
503,13273.0,112,16,138.98,1,4,2,7,Potential Loyalists
504,13276.0,63,30,590.9300000000001,1,2,1,4,Lost Customers
505,13277.0,15,8,258.4,3,1,1,5,At Risk
506,13278.0,40,46,542.73,2,1,1,4,Lost Customers
507,13279.0,63,11,126.30000000000001,1,2,1,4,Lost Customers
508,13280.0,121,85,814.86,1,4,2,7,Potential Loyalists
509,13282.0,17,40,1047.84,3,1,1,5,At Risk
510,13283.0,59,7,93.66,1,2,1,4,Lost Customers
511,13284.0,322,14,196.15,1,5,3,9,Best Customers
512,13285.0,22,187,2709.12,3,1,1,5,At Risk
513,13291.0,155,42,361.11,1,5,2,8,Loyal Customers
514,13292.0,38,31,578.9399999999999,2,1,1,4,Lost Customers
515,13294.0,189,54,873.74,1,5,2,8,Loyal Customers
516,13295.0,359,11,197.95000000000002,1,5,3,9,Best Customers
517,13296.0,136,5,87.4,1,4,2,7,Potential Loyalists
518,13297.0,7,59,2089.85,5,1,1,7,Potential Loyalists
519,13298.0,0,2,360.0,5,1,1,7,Potential Loyalists
520,13299.0,267,5,142.5,1,5,2,8,Loyal Customers
521,13300.0,164,22,365.29,1,5,2,8,Loyal Customers
522,13301.0,103,80,600.1899999999999,1,4,2,7,Potential Loyalists
523,13302.0,154,1,63.75,1,5,2,8,Loyal Customers
524,13304.0,350,21,300.42,1,5,3,9,Best Customers
525,13305.0,3,81,2000.86,5,1,1,7,Potential Loyalists
526,13307.0,119,1,15.0,1,4,2,7,Potential Loyalists
527,13308.0,22,57,1367.6100000000001,3,1,1,5,At Risk
528,13309.0,6,107,1456.79,5,1,1,7,Potential Loyalists
529,13310.0,8,77,1083.63,4,1,1,6,Potential Loyalists
530,13311.0,3,26,598.57,5,1,1,7,Potential Loyalists
531,13313.0,21,78,1555.3200000000002,3,1,1,5,At Risk
532,13314.0,1,75,578.66,5,1,1,7,Potential Loyalists
533,13316.0,36,87,5977.73,2,1,1,4,Lost Customers
534,13317.0,63,135,2140.07,1,2,1,4,Lost Customers
535,13318.0,0,20,640.76,5,1,1,7,Potential Loyalists
536,13319.0,4,500,10664.34,5,1,1,7,Potential Loyalists
537,13320.0,69,110,1491.7,1,2,1,4,Lost Customers
538,13321.0,71,11,567.36,1,2,1,4,Lost Customers
539,13322.0,16,25,199.48000000000002,3,1,1,5,At Risk
540,13323.0,2,21,787.85,5,1,1,7,Potential Loyalists
541,13324.0,31,77,7072.8,2,1,1,4,Lost Customers
542,13325.0,81,12,675.3,1,3,1,5,At Risk
543,13327.0,38,109,3617.57,2,1,1,4,Lost Customers
544,13328.0,315,17,1308.48,1,5,3,9,Best Customers
545,13329.0,31,19,740.4,2,1,1,4,Lost Customers
546,13330.0,92,53,1140.93,1,3,1,5,At Risk
547,13332.0,13,21,350.9,4,1,1,6,Potential Loyalists
548,13334.0,81,268,3536.82,1,3,1,5,At Risk
549,13336.0,76,51,795.12,1,3,1,5,At Risk
550,13338.0,153,24,431.82,1,5,2,8,Loyal Customers
551,13339.0,200,54,860.12,1,5,2,8,Loyal Customers
552,13340.0,44,134,10736.48,2,2,1,5,At Risk
553,13341.0,260,42,775.85,1,5,2,8,Loyal Customers
554,13343.0,172,22,303.93,1,5,2,8,Loyal Customers
555,13344.0,67,119,2543.72,1,2,1,4,Lost Customers
556,13345.0,276,22,377.6,1,5,2,8,Loyal Customers
557,13347.0,69,8,341.35999999999996,1,2,1,4,Lost Customers
558,13348.0,63,14,233.76000000000002,1,2,1,4,Lost Customers
559,13349.0,10,16,247.32,4,1,1,6,Potential Loyalists
560,13350.0,15,43,910.72,3,1,1,5,At Risk
561,13351.0,65,16,373.94,1,2,1,4,Lost Customers
562,13352.0,7,27,389.28,5,1,1,7,Potential Loyalists
563,13354.0,70,51,743.53,1,2,1,4,Lost Customers
564,13355.0,121,32,674.7,1,4,2,7,Potential Loyalists
565,13356.0,79,42,768.24,1,3,1,5,At Risk
566,13357.0,256,90,609.95,1,5,2,8,Loyal Customers
567,13358.0,268,29,439.03,1,5,2,8,Loyal Customers
568,13359.0,58,24,431.26,1,2,1,4,Lost Customers
569,13362.0,2,169,3085.4900000000002,5,1,1,7,Potential Loyalists
570,13363.0,17,60,992.5,3,1,1,5,At Risk
572,13365.0,8,132,2191.22,4,1,1,6,Potential Loyalists
573,13366.0,49,1,56.16,1,2,1,4,Lost Customers
574,13368.0,256,29,623.4,1,5,2,8,Loyal Customers
575,13369.0,353,19,263.75,1,5,3,9,Best Customers
576,13370.0,365,44,721.32,1,5,3,9,Best Customers
577,13372.0,89,23,378.64,1,3,1,5,At Risk
578,13373.0,60,158,3312.25,1,2,1,4,Lost Customers
579,13375.0,80,38,772.9,1,3,1,5,At Risk
580,13376.0,98,53,1019.76,1,3,1,5,At Risk
581,13379.0,25,97,572.56,3,1,1,5,At Risk
582,13381.0,20,173,3626.81,3,1,1,5,At Risk
583,13382.0,280,15,222.99,1,5,2,8,Loyal Customers
584,13384.0,30,155,4122.28,3,1,1,5,At Risk
585,13385.0,329,35,534.57,1,5,3,9,Best Customers
586,13388.0,120,36,627.15,1,4,2,7,Potential Loyalists
587,13389.0,10,51,797.96,4,1,1,6,Potential Loyalists
588,13390.0,74,13,544.08,1,2,1,4,Lost Customers
589,13391.0,203,1,59.8,1,5,2,8,Loyal Customers
590,13394.0,1,163,2318.3,5,1,1,7,Potential Loyalists
591,13395.0,184,21,307.72,1,5,2,8,Loyal Customers
592,13396.0,21,47,1325.29,3,1,1,5,At Risk
593,13397.0,72,39,1539.18,1,2,1,4,Lost Customers
594,13398.0,191,26,457.34,1,5,2,8,Loyal Customers
595,13402.0,126,39,621.23,1,4,2,7,Potential Loyalists
596,13403.0,17,3,75.0,3,1,1,5,At Risk
597,13404.0,0,11,252.49,5,1,1,7,Potential Loyalists
598,13405.0,203,25,557.45,1,5,2,8,Loyal Customers
599,13408.0,1,492,27888.38,5,1,1,7,Potential Loyalists
600,13410.0,8,30,988.91,4,1,1,6,Potential Loyalists
601,13411.0,106,18,213.55,1,4,2,7,Potential Loyalists
602,13414.0,133,24,1390.5,1,4,2,7,Potential Loyalists
603,13416.0,43,19,712.5,2,2,1,5,At Risk
604,13417.0,4,28,640.83,5,1,1,7,Potential Loyalists
605,13418.0,11,314,5845.44,4,1,1,6,Potential Loyalists
606,13419.0,63,16,221.06,1,2,1,4,Lost Customers
607,13420.0,134,10,140.35,1,4,2,7,Potential Loyalists
608,13421.0,39,104,1838.48,2,1,1,4,Lost Customers
609,13422.0,50,128,2601.55,1,2,1,4,Lost Customers
610,13425.0,107,78,1624.21,1,4,2,7,Potential Loyalists
611,13426.0,0,158,3558.32,5,1,1,7,Potential Loyalists
612,13427.0,18,29,582.6,3,1,1,5,At Risk
613,13428.0,9,74,218.47,4,1,1,6,Potential Loyalists
614,13429.0,10,67,1006.8,4,1,1,6,Potential Loyalists
615,13430.0,18,53,652.0699999999999,3,1,1,5,At Risk
616,13431.0,66,46,1269.1,1,2,1,4,Lost Customers
617,13434.0,73,10,534.24,1,2,1,4,Lost Customers
618,13435.0,4,103,3794.4900000000002,5,1,1,7,Potential Loyalists
619,13436.0,1,12,196.89,5,1,1,7,Potential Loyalists
620,13437.0,13,167,3408.06,4,1,1,6,Potential Loyalists
621,13439.0,254,54,283.71,1,5,2,8,Loyal Customers
622,13441.0,91,13,296.64,1,3,1,5,At Risk
623,13447.0,22,62,1104.23,3,1,1,5,At Risk
624,13448.0,16,199,3465.67,3,1,1,5,At Risk
625,13449.0,23,19,291.88,3,1,1,5,At Risk
626,13450.0,26,71,2043.72,3,1,1,5,At Risk
627,13451.0,25,444,2916.45,3,1,1,5,At Risk
628,13452.0,258,2,590.0,1,5,2,8,Loyal Customers
629,13453.0,165,17,356.97999999999996,1,5,2,8,Loyal Customers
630,13455.0,24,53,1007.35,3,1,1,5,At Risk
631,13456.0,17,65,1737.8200000000002,3,1,1,5,At Risk
632,13458.0,6,394,9537.92,5,1,1,7,Potential Loyalists
633,13460.0,28,17,183.44,3,1,1,5,At Risk
634,13461.0,38,27,1445.0,2,1,1,4,Lost Customers
635,13462.0,182,10,143.25,1,5,2,8,Loyal Customers
636,13464.0,57,41,674.68,1,2,1,4,Lost Customers
637,13466.0,99,18,297.95,1,3,1,5,At Risk
638,13467.0,10,99,1083.71,4,1,1,6,Potential Loyalists
639,13468.0,1,306,5656.75,5,1,1,7,Potential Loyalists
640,13470.0,98,10,165.0,1,3,1,5,At Risk
641,13471.0,0,260,2531.58,5,1,1,7,Potential Loyalists
642,13473.0,60,22,417.54,1,2,1,4,Lost Customers
643,13474.0,235,64,229.59,1,5,2,8,Loyal Customers
644,13475.0,190,86,1431.78,1,5,2,8,Loyal Customers
645,13476.0,178,61,1092.77,1,5,2,8,Loyal Customers
646,13477.0,37,81,1441.53,2,1,1,4,Lost Customers
647,13479.0,197,16,291.0,1,5,2,8,Loyal Customers
648,13481.0,45,112,1776.81,2,2,1,5,At Risk
649,13482.0,231,11,184.64,1,5,2,8,Loyal Customers
650,13483.0,65,10,140.34,1,2,1,4,Lost Customers
651,13484.0,240,8,313.8,1,5,2,8,Loyal Customers
652,13485.0,232,23,454.24,1,5,2,8,Loyal Customers
653,13486.0,77,69,1122.41,1,3,1,5,At Risk
654,13487.0,57,34,575.4,1,2,1,4,Lost Customers
655,13488.0,16,427,8910.61,3,1,1,5,At Risk
656,13489.0,104,14,449.52,1,4,2,7,Potential Loyalists
657,13491.0,51,86,1215.82,1,2,1,4,Lost Customers
658,13494.0,311,18,316.26000000000005,1,5,3,9,Best Customers
659,13495.0,7,52,1990.12,5,1,1,7,Potential Loyalists
660,13496.0,10,36,617.93,4,1,1,6,Potential Loyalists
661,13497.0,282,20,321.05,1,5,2,8,Loyal Customers
662,13499.0,17,45,1146.96,3,1,1,5,At Risk
663,13500.0,22,67,1136.77,3,1,1,5,At Risk
664,13502.0,16,18,292.0,3,1,1,5,At Risk
665,13503.0,70,17,216.85,1,2,1,4,Lost Customers
666,13504.0,63,22,295.93,1,2,1,4,Lost Customers
667,13506.0,311,29,452.82,1,5,3,9,Best Customers
668,13507.0,2,162,2479.16,5,1,1,7,Potential Loyalists
669,13508.0,243,12,110.97,1,5,2,8,Loyal Customers
670,13509.0,8,43,964.72,4,1,1,6,Potential Loyalists
671,13510.0,0,117,1785.16,5,1,1,7,Potential Loyalists
672,13512.0,260,15,251.21,1,5,2,8,Loyal Customers
673,13513.0,126,10,205.1,1,4,2,7,Potential Loyalists
674,13514.0,73,4,152.20000000000002,1,2,1,4,Lost Customers
675,13515.0,72,59,891.12,1,2,1,4,Lost Customers
676,13516.0,20,44,1389.41,3,1,1,5,At Risk
677,13517.0,59,143,2109.07,1,2,1,4,Lost Customers
678,13518.0,85,38,659.4399999999999,1,3,1,5,At Risk
679,13519.0,49,9,110.8,1,2,1,4,Lost Customers
680,13521.0,0,435,1092.39,5,1,1,7,Potential Loyalists
681,13522.0,29,5,125.80000000000001,3,1,1,5,At Risk
682,13523.0,32,177,3755.38,2,1,1,4,Lost Customers
683,13524.0,40,27,680.1800000000001,2,1,1,4,Lost Customers
684,13525.0,14,6,628.78,4,1,1,6,Potential Loyalists
685,13527.0,33,224,2263.76,2,1,1,4,Lost Customers
686,13529.0,78,15,307.76,1,3,1,5,At Risk
687,13531.0,204,22,483.8,1,5,2,8,Loyal Customers
688,13532.0,33,66,210.31,2,1,1,4,Lost Customers
689,13533.0,182,76,270.79,1,5,2,8,Loyal Customers
690,13534.0,1,342,5613.08,5,1,1,7,Potential Loyalists
691,13536.0,0,179,3448.29,5,1,1,7,Potential Loyalists
692,13538.0,42,25,1280.85,2,2,1,5,At Risk
693,13539.0,85,38,605.84,1,3,1,5,At Risk
694,13544.0,39,87,291.41,2,1,1,4,Lost Customers
695,13546.0,11,98,626.99,4,1,1,6,Potential Loyalists
696,13548.0,95,124,682.41,1,3,1,5,At Risk
697,13549.0,25,52,916.12,3,1,1,5,At Risk
698,13551.0,318,4,91.80000000000001,1,5,3,9,Best Customers
699,13552.0,65,121,3539.53,1,2,1,4,Lost Customers
700,13555.0,73,136,4149.28,1,2,1,4,Lost Customers
701,13557.0,27,34,584.0600000000001,3,1,1,5,At Risk
702,13558.0,5,175,605.06,5,1,1,7,Potential Loyalists
703,13560.0,6,33,174.37,5,1,1,7,Potential Loyalists
704,13561.0,215,14,141.85999999999999,1,5,2,8,Loyal Customers
705,13562.0,81,82,1799.33,1,3,1,5,At Risk
706,13563.0,83,49,777.53,1,3,1,5,At Risk
707,13564.0,353,82,1198.38,1,5,3,9,Best Customers
708,13565.0,18,38,240.22,3,1,1,5,At Risk
709,13566.0,40,176,874.71,2,1,1,4,Lost Customers
710,13568.0,172,44,192.85,1,5,2,8,Loyal Customers
711,13569.0,16,84,372.25,3,1,1,5,At Risk
712,13570.0,242,27,239.49,1,5,2,8,Loyal Customers
713,13571.0,12,341,2092.32,4,1,1,6,Potential Loyalists
714,13572.0,205,33,1384.25,1,5,2,8,Loyal Customers
715,13573.0,49,26,294.4,1,2,1,4,Lost Customers
716,13575.0,22,46,732.0699999999999,3,1,1,5,At Risk
717,13576.0,9,130,6703.3,4,1,1,6,Potential Loyalists
718,13577.0,24,85,1658.3,3,1,1,5,At Risk
719,13579.0,14,23,467.04,4,1,1,6,Potential Loyalists
720,13581.0,308,10,118.0,1,5,3,9,Best Customers
721,13583.0,155,53,781.03,1,5,2,8,Loyal Customers
722,13584.0,306,24,142.4,1,5,3,9,Best Customers
723,13587.0,31,11,347.0,2,1,1,4,Lost Customers
724,13588.0,15,179,2449.5299999999997,3,1,1,5,At Risk
725,13589.0,14,21,379.65,4,1,1,6,Potential Loyalists
726,13590.0,10,89,1976.1200000000001,4,1,1,6,Potential Loyalists
727,13591.0,64,58,1117.13,1,2,1,4,Lost Customers
728,13592.0,35,16,247.95999999999998,2,1,1,4,Lost Customers
729,13593.0,107,129,1990.28,1,4,2,7,Potential Loyalists
730,13594.0,52,26,396.97,1,2,1,4,Lost Customers
731,13596.0,5,166,697.04,5,1,1,7,Potential Loyalists
732,13598.0,46,41,167.42000000000002,2,2,1,5,At Risk
733,13599.0,0,263,5032.32,5,1,1,7,Potential Loyalists
734,13600.0,311,19,219.52,1,5,3,9,Best Customers
735,13601.0,44,99,693.32,2,2,1,5,At Risk
736,13602.0,64,23,428.89,1,2,1,4,Lost Customers
737,13603.0,25,27,164.34,3,1,1,5,At Risk
738,13606.0,28,43,280.54,3,1,1,5,At Risk
739,13607.0,39,98,678.01,2,1,1,4,Lost Customers
740,13610.0,11,228,1115.43,4,1,1,6,Potential Loyalists
741,13611.0,88,76,1158.2,1,3,1,5,At Risk
742,13614.0,23,201,1610.46,3,1,1,5,At Risk
743,13615.0,312,24,399.99,1,5,3,9,Best Customers
744,13617.0,39,44,544.18,2,1,1,4,Lost Customers
745,13618.0,173,13,177.34,1,5,2,8,Loyal Customers
746,13621.0,116,19,213.85,1,4,2,7,Potential Loyalists
747,13623.0,30,85,716.24,3,1,1,5,At Risk
748,13626.0,252,19,257.23,1,5,2,8,Loyal Customers
749,13627.0,58,94,1624.02,1,2,1,4,Lost Customers
750,13629.0,22,59,7792.36,3,1,1,5,At Risk
751,13630.0,4,80,1995.6799999999998,5,1,1,7,Potential Loyalists
752,13631.0,99,12,3021.77,1,3,1,5,At Risk
753,13632.0,24,147,2117.02,3,1,1,5,At Risk
754,13634.0,32,188,1575.16,2,1,1,4,Lost Customers
755,13635.0,67,62,1071.03,1,2,1,4,Lost Customers
756,13636.0,36,64,941.62,2,1,1,4,Lost Customers
757,13637.0,51,100,809.25,1,2,1,4,Lost Customers
758,13638.0,15,8,122.64,3,1,1,5,At Risk
759,13639.0,73,40,1033.34,1,2,1,4,Lost Customers
760,13642.0,215,66,354.8,1,5,2,8,Loyal Customers
761,13643.0,30,28,519.44,3,1,1,5,At Risk
762,13644.0,8,148,2597.52,4,1,1,6,Potential Loyalists
763,13645.0,119,5,252.1,1,4,2,7,Potential Loyalists
764,13647.0,9,80,1670.22,4,1,1,6,Potential Loyalists
765,13649.0,256,23,346.6,1,5,2,8,Loyal Customers
766,13650.0,16,98,1809.3400000000001,3,1,1,5,At Risk
767,13651.0,39,5,79.2,2,1,1,4,Lost Customers
768,13652.0,45,63,1095.08,2,2,1,5,At Risk
769,13654.0,42,166,2707.33,2,2,1,5,At Risk
770,13655.0,113,56,932.97,1,4,2,7,Potential Loyalists
771,13656.0,164,49,379.65,1,5,2,8,Loyal Customers
772,13657.0,10,16,382.14,4,1,1,6,Potential Loyalists
773,13658.0,9,112,2421.47,4,1,1,6,Potential Loyalists
774,13659.0,196,108,1550.85,1,5,2,8,Loyal Customers
775,13662.0,85,58,879.08,1,3,1,5,At Risk
776,13663.0,178,13,189.47,1,5,2,8,Loyal Customers
777,13666.0,59,12,84.65,1,2,1,4,Lost Customers
778,13667.0,148,87,305.02,1,4,2,7,Potential Loyalists
779,13668.0,2,501,6216.07,5,1,1,7,Potential Loyalists
780,13669.0,50,9,218.55,1,2,1,4,Lost Customers
781,13670.0,74,25,349.7,1,2,1,4,Lost Customers
783,13673.0,18,65,396.92,3,1,1,5,At Risk
784,13675.0,150,25,486.82000000000005,1,5,2,8,Loyal Customers
785,13678.0,151,16,232.6,1,5,2,8,Loyal Customers
786,13680.0,0,216,2202.31,5,1,1,7,Potential Loyalists
787,13681.0,17,57,827.83,3,1,1,5,At Risk
788,13682.0,186,3,59.5,1,5,2,8,Loyal Customers
789,13684.0,285,31,64.23,1,5,2,8,Loyal Customers
790,13685.0,2,39,3119.44,5,1,1,7,Potential Loyalists
791,13686.0,182,8,72.0,1,5,2,8,Loyal Customers
792,13689.0,62,6,910.0,1,2,1,4,Lost Customers
793,13690.0,58,9,172.25,1,2,1,4,Lost Customers
794,13692.0,24,54,1473.3700000000001,3,1,1,5,At Risk
796,13694.0,3,582,62924.1,5,1,1,7,Potential Loyalists
797,13695.0,30,90,2504.13,3,1,1,5,At Risk
798,13697.0,38,12,151.29999999999998,2,1,1,4,Lost Customers
799,13699.0,154,14,308.58000000000004,1,5,2,8,Loyal Customers
800,13700.0,25,197,2265.12,3,1,1,5,At Risk
801,13703.0,317,1,99.5,1,5,3,9,Best Customers
802,13704.0,4,135,2295.31,5,1,1,7,Potential Loyalists
803,13705.0,7,28,711.86,5,1,1,7,Potential Loyalists
804,13706.0,302,20,330.79,1,5,3,9,Best Customers
805,13707.0,266,48,806.41,1,5,2,8,Loyal Customers
806,13708.0,270,50,294.88,1,5,2,8,Loyal Customers
807,13709.0,3,346,6249.11,5,1,1,7,Potential Loyalists
808,13710.0,31,8,180.48,2,1,1,4,Lost Customers
809,13711.0,218,13,252.06,1,5,2,8,Loyal Customers
810,13712.0,246,10,228.84,1,5,2,8,Loyal Customers
811,13715.0,280,108,1053.94,1,5,2,8,Loyal Customers
812,13716.0,268,21,138.28,1,5,2,8,Loyal Customers
813,13717.0,31,103,1432.26,2,1,1,4,Lost Customers
814,13718.0,245,12,306.55,1,5,2,8,Loyal Customers
815,13719.0,14,60,1041.68,4,1,1,6,Potential Loyalists
816,13720.0,116,43,799.9,1,4,2,7,Potential Loyalists
817,13721.0,35,28,524.14,2,1,1,4,Lost Customers
818,13722.0,119,86,2369.16,1,4,2,7,Potential Loyalists
819,13723.0,216,6,199.85000000000002,1,5,2,8,Loyal Customers
820,13725.0,49,118,1809.81,1,2,1,4,Lost Customers
821,13726.0,38,42,1079.66,2,1,1,4,Lost Customers
822,13727.0,28,20,333.48,3,1,1,5,At Risk
823,13728.0,36,63,1016.14,2,1,1,4,Lost Customers
824,13730.0,135,43,752.6,1,4,2,7,Potential Loyalists
825,13731.0,218,38,610.59,1,5,2,8,Loyal Customers
826,13732.0,27,33,491.86,3,1,1,5,At Risk
827,13735.0,24,208,2766.18,3,1,1,5,At Risk
828,13736.0,4,194,724.0,5,1,1,7,Potential Loyalists
829,13737.0,199,30,339.59999999999997,1,5,2,8,Loyal Customers
830,13739.0,17,3,216.9,3,1,1,5,At Risk
831,13740.0,240,23,350.75,1,5,2,8,Loyal Customers
832,13741.0,71,35,666.33,1,2,1,4,Lost Customers
833,13742.0,16,323,3102.42,3,1,1,5,At Risk
834,13743.0,2,42,1340.1499999999999,5,1,1,7,Potential Loyalists
835,13744.0,94,72,1156.36,1,3,1,5,At Risk
836,13745.0,150,26,291.54,1,5,2,8,Loyal Customers
837,13747.0,373,1,79.6,1,5,3,9,Best Customers
838,13748.0,95,28,948.25,1,3,1,5,At Risk
839,13750.0,53,24,1647.26,1,2,1,4,Lost Customers
840,13751.0,287,9,296.25,1,5,2,8,Loyal Customers
841,13752.0,123,76,1186.28,1,4,2,7,Potential Loyalists
842,13753.0,287,35,741.26,1,5,2,8,Loyal Customers
843,13754.0,151,12,282.6,1,5,2,8,Loyal Customers
844,13755.0,3,343,2154.68,5,1,1,7,Potential Loyalists
845,13756.0,1,143,5145.12,5,1,1,7,Potential Loyalists
846,13758.0,11,117,3190.55,4,1,1,6,Potential Loyalists
847,13759.0,32,25,659.4100000000001,2,1,1,4,Lost Customers
848,13760.0,53,57,286.79,1,2,1,4,Lost Customers
849,13761.0,49,70,1070.65,1,2,1,4,Lost Customers
851,13763.0,62,17,1689.46,1,2,1,4,Lost Customers
852,13764.0,70,207,1518.76,1,2,1,4,Lost Customers
853,13767.0,1,399,16945.71,5,1,1,7,Potential Loyalists
854,13769.0,1,143,2771.87,5,1,1,7,Potential Loyalists
855,13771.0,63,120,2631.7,1,2,1,4,Lost Customers
856,13772.0,33,177,1132.13,2,1,1,4,Lost Customers
857,13774.0,81,22,345.0,1,3,1,5,At Risk
858,13777.0,0,217,25758.100000000002,5,1,1,7,Potential Loyalists
859,13778.0,102,9,178.7,1,3,2,6,Potential Loyalists
860,13780.0,6,57,360.01,5,1,1,7,Potential Loyalists
861,13781.0,250,17,127.84,1,5,2,8,Loyal Customers
862,13782.0,12,115,912.0,4,1,1,6,Potential Loyalists
863,13784.0,9,31,2462.79,4,1,1,6,Potential Loyalists
864,13786.0,366,7,230.4,1,5,3,9,Best Customers
865,13787.0,75,31,309.04,1,3,1,5,At Risk
866,13790.0,3,45,348.79999999999995,5,1,1,7,Potential Loyalists
867,13791.0,42,17,1047.68,2,2,1,5,At Risk
868,13792.0,65,13,195.55,1,2,1,4,Lost Customers
869,13798.0,0,439,36351.42,5,1,1,7,Potential Loyalists
870,13799.0,116,39,688.86,1,4,2,7,Potential Loyalists
871,13800.0,309,33,558.32,1,5,3,9,Best Customers
872,13801.0,66,23,324.8,1,2,1,4,Lost Customers
873,13802.0,137,66,3906.27,1,4,2,7,Potential Loyalists
874,13803.0,254,17,277.07,1,5,2,8,Loyal Customers
875,13804.0,30,137,2635.79,3,1,1,5,At Risk
876,13805.0,51,13,924.5999999999999,1,2,1,4,Lost Customers
877,13806.0,63,10,256.38,1,2,1,4,Lost Customers
878,13807.0,366,7,112.6,1,5,3,9,Best Customers
879,13808.0,5,76,1747.66,5,1,1,7,Potential Loyalists
880,13810.0,28,32,827.51,3,1,1,5,At Risk
881,13811.0,183,10,519.75,1,5,2,8,Loyal Customers
882,13812.0,41,33,485.0,2,1,1,4,Lost Customers
883,13813.0,39,67,1155.41,2,1,1,4,Lost Customers
884,13814.0,55,58,1562.12,1,2,1,4,Lost Customers
885,13815.0,21,174,3654.91,3,1,1,5,At Risk
886,13816.0,23,31,483.04,3,1,1,5,At Risk
887,13817.0,28,22,328.98,3,1,1,5,At Risk
888,13819.0,301,36,1140.35,1,5,3,9,Best Customers
889,13821.0,144,59,385.64,1,4,2,7,Potential Loyalists
890,13822.0,5,96,632.0,5,1,1,7,Potential Loyalists
891,13823.0,18,40,957.66,3,1,1,5,At Risk
892,13824.0,32,46,1698.94,2,1,1,4,Lost Customers
893,13826.0,157,11,179.55,1,5,2,8,Loyal Customers
894,13827.0,57,93,412.05,1,2,1,4,Lost Customers
895,13828.0,21,15,209.49,3,1,1,5,At Risk
897,13831.0,15,74,2202.99,3,1,1,5,At Risk
898,13832.0,17,4,40.949999999999996,3,1,1,5,At Risk
899,13833.0,158,29,384.8,1,5,2,8,Loyal Customers
900,13835.0,24,55,834.57,3,1,1,5,At Risk
901,13837.0,211,19,271.24,1,5,2,8,Loyal Customers
902,13838.0,5,174,691.73,5,1,1,7,Potential Loyalists
903,13841.0,252,1,85.0,1,5,2,8,Loyal Customers
904,13842.0,58,206,3385.62,1,2,1,4,Lost Customers
905,13844.0,10,20,361.62,4,1,1,6,Potential Loyalists
906,13845.0,64,9,312.98,1,2,1,4,Lost Customers
907,13846.0,24,58,847.61,3,1,1,5,At Risk
908,13848.0,91,5,1255.0,1,3,1,5,At Risk
909,13849.0,51,101,1537.95,1,2,1,4,Lost Customers
910,13850.0,87,94,1586.81,1,3,1,5,At Risk
911,13851.0,95,81,2651.46,1,3,1,5,At Risk
912,13853.0,8,24,1056.94,4,1,1,6,Potential Loyalists
913,13854.0,8,114,8025.0199999999995,4,1,1,6,Potential Loyalists
914,13856.0,168,17,363.4,1,5,2,8,Loyal Customers
915,13858.0,56,11,216.17000000000002,1,2,1,4,Lost Customers
916,13859.0,325,28,201.16,1,5,3,9,Best Customers
917,13860.0,0,77,1240.0,5,1,1,7,Potential Loyalists
918,13862.0,17,142,2187.31,3,1,1,5,At Risk
919,13863.0,244,22,299.56,1,5,2,8,Loyal Customers
920,13865.0,57,30,501.56,1,2,1,4,Lost Customers
921,13866.0,73,7,145.67,1,2,1,4,Lost Customers
922,13867.0,30,61,1015.29,3,1,1,5,At Risk
923,13868.0,6,33,3192.54,5,1,1,7,Potential Loyalists
924,13869.0,122,307,3104.9500000000003,1,4,2,7,Potential Loyalists
925,13870.0,1,118,2751.25,5,1,1,7,Potential Loyalists
926,13871.0,22,338,6389.8,3,1,1,5,At Risk
927,13873.0,119,24,381.7,1,4,2,7,Potential Loyalists
928,13874.0,357,18,540.45,1,5,3,9,Best Customers
929,13875.0,53,104,1786.79,1,2,1,4,Lost Customers
930,13876.0,63,7,122.7,1,2,1,4,Lost Customers
931,13877.0,85,3,117.24,1,3,1,5,At Risk
932,13878.0,54,36,1281.53,1,2,1,4,Lost Customers
933,13880.0,20,165,3219.77,3,1,1,5,At Risk
934,13881.0,3,180,16989.52,5,1,1,7,Potential Loyalists
935,13882.0,2,66,1131.28,5,1,1,7,Potential Loyalists
936,13883.0,0,154,2542.25,5,1,1,7,Potential Loyalists
937,13884.0,6,60,781.3000000000001,5,1,1,7,Potential Loyalists
938,13885.0,188,28,506.8,1,5,2,8,Loyal Customers
939,13886.0,70,16,243.56,1,2,1,4,Lost Customers
940,13887.0,203,19,349.55,1,5,2,8,Loyal Customers
941,13888.0,119,40,605.63,1,4,2,7,Potential Loyalists
942,13889.0,92,15,416.90000000000003,1,3,1,5,At Risk
943,13890.0,0,114,1860.8600000000001,5,1,1,7,Potential Loyalists
944,13892.0,26,27,632.97,3,1,1,5,At Risk
945,13893.0,297,21,821.1,1,5,2,8,Loyal Customers
946,13894.0,21,30,535.97,3,1,1,5,At Risk
947,13895.0,20,119,2588.12,3,1,1,5,At Risk
948,13897.0,49,17,311.16,1,2,1,4,Lost Customers
949,13898.0,325,12,155.93,1,5,3,9,Best Customers
950,13899.0,15,19,388.52,3,1,1,5,At Risk
951,13900.0,182,43,740.95,1,5,2,8,Loyal Customers
952,13901.0,71,149,2867.2,1,2,1,4,Lost Customers
953,13904.0,36,26,332.64,2,1,1,4,Lost Customers
954,13908.0,79,126,2347.05,1,3,1,5,At Risk
955,13911.0,56,148,2580.91,1,2,1,4,Lost Customers
956,13914.0,3,34,613.95,5,1,1,7,Potential Loyalists
957,13917.0,49,18,272.04,1,2,1,4,Lost Customers
958,13918.0,49,30,1212.8400000000001,1,2,1,4,Lost Customers
959,13922.0,351,7,172.25,1,5,3,9,Best Customers
960,13923.0,53,20,351.13,1,2,1,4,Lost Customers
961,13924.0,1,137,1682.08,5,1,1,7,Potential Loyalists
962,13925.0,35,45,616.65,2,1,1,4,Lost Customers
963,13926.0,22,11,223.85000000000002,3,1,1,5,At Risk
964,13927.0,74,21,348.99,1,2,1,4,Lost Customers
965,13928.0,10,27,464.57,4,1,1,6,Potential Loyalists
966,13929.0,168,10,802.85,1,5,2,8,Loyal Customers
967,13930.0,57,17,337.34,1,2,1,4,Lost Customers
968,13931.0,85,59,1230.93,1,3,1,5,At Risk
969,13932.0,294,16,307.4,1,5,2,8,Loyal Customers
970,13933.0,108,23,608.79,1,4,2,7,Potential Loyalists
971,13934.0,263,31,922.1,1,5,2,8,Loyal Customers
972,13936.0,170,27,361.28,1,5,2,8,Loyal Customers
973,13937.0,168,9,158.85,1,5,2,8,Loyal Customers
974,13938.0,34,7,71.66,2,1,1,4,Lost Customers
975,13939.0,22,46,556.75,3,1,1,5,At Risk
976,13940.0,16,49,839.14,3,1,1,5,At Risk
977,13941.0,21,47,4912.41,3,1,1,5,At Risk
978,13946.0,78,11,561.57,1,3,1,5,At Risk
979,13947.0,64,5,90.6,1,2,1,4,Lost Customers
980,13948.0,360,3,102.0,1,5,3,9,Best Customers
981,13949.0,2,160,2427.32,5,1,1,7,Potential Loyalists
982,13950.0,10,36,728.56,4,1,1,6,Potential Loyalists
983,13951.0,175,39,674.45,1,5,2,8,Loyal Customers
984,13952.0,210,137,3246.09,1,5,2,8,Loyal Customers
985,13953.0,6,20,3515.68,5,1,1,7,Potential Loyalists
986,13954.0,1,30,378.59,5,1,1,7,Potential Loyalists
987,13955.0,153,33,322.96,1,5,2,8,Loyal Customers
988,13956.0,4,152,1026.42,5,1,1,7,Potential Loyalists
990,13959.0,78,92,598.2,1,3,1,5,At Risk
991,13960.0,20,12,230.22,3,1,1,5,At Risk
992,13962.0,21,11,169.54999999999998,3,1,1,5,At Risk
993,13963.0,307,35,664.54,1,5,3,9,Best Customers
994,13967.0,145,2,80.7,1,4,2,7,Potential Loyalists
995,13969.0,6,633,8986.69,5,1,1,7,Potential Loyalists
996,13971.0,8,158,2702.2200000000003,4,1,1,6,Potential Loyalists
997,13972.0,70,15,190.25,1,2,1,4,Lost Customers
998,13973.0,286,11,264.7,1,5,2,8,Loyal Customers
999,13974.0,48,28,413.59000000000003,1,2,1,4,Lost Customers
1000,13975.0,30,340,2503.23,3,1,1,5,At Risk
1001,13976.0,206,10,357.98,1,5,2,8,Loyal Customers
1002,13978.0,14,15,196.79,4,1,1,6,Potential Loyalists
1003,13979.0,72,54,869.87,1,2,1,4,Lost Customers
1004,13980.0,59,11,200.14,1,2,1,4,Lost Customers
1005,13982.0,38,115,1861.11,2,1,1,4,Lost Customers
1006,13983.0,29,112,2590.46,3,1,1,5,At Risk
1007,13984.0,26,17,488.03,3,1,1,5,At Risk
1008,13985.0,3,353,7024.53,5,1,1,7,Potential Loyalists
1009,13986.0,16,13,320.46,3,1,1,5,At Risk
1010,13988.0,19,239,4098.8,3,1,1,5,At Risk
1011,13989.0,65,41,1266.08,1,2,1,4,Lost Customers
1012,13990.0,212,16,311.3,1,5,2,8,Loyal Customers
1013,13991.0,11,85,849.63,4,1,1,6,Potential Loyalists
1014,13992.0,29,5,76.8,3,1,1,5,At Risk
1015,13993.0,31,125,3409.66,2,1,1,4,Lost Customers
1016,13994.0,3,155,2313.14,5,1,1,7,Potential Loyalists
1017,13995.0,14,87,1383.49,4,1,1,6,Potential Loyalists
1018,13999.0,9,212,3865.26,4,1,1,6,Potential Loyalists
1019,14000.0,205,16,633.71,1,5,2,8,Loyal Customers
1020,14001.0,45,39,2043.0800000000002,2,2,1,5,At Risk
1021,14002.0,133,47,529.73,1,4,2,7,Potential Loyalists
1022,14004.0,42,171,4582.64,2,2,1,5,At Risk
1023,14005.0,9,84,2874.72,4,1,1,6,Potential Loyalists
1024,14006.0,115,30,962.19,1,4,2,7,Potential Loyalists
1025,14009.0,197,44,685.9300000000001,1,5,2,8,Loyal Customers
1026,14012.0,277,11,328.8,1,5,2,8,Loyal Customers
1027,14013.0,109,34,473.02,1,4,2,7,Potential Loyalists
1028,14014.0,76,39,505.18,1,3,1,5,At Risk
1029,14015.0,52,20,917.34,1,2,1,4,Lost Customers
1030,14016.0,153,162,4328.46,1,5,2,8,Loyal Customers
1031,14019.0,46,68,1398.96,2,2,1,5,At Risk
1032,14020.0,16,39,642.8,3,1,1,5,At Risk
1033,14021.0,154,22,631.9,1,5,2,8,Loyal Customers
1034,14022.0,224,28,440.0,1,5,2,8,Loyal Customers
1035,14023.0,6,31,584.07,5,1,1,7,Potential Loyalists
1036,14024.0,121,16,327.7,1,4,2,7,Potential Loyalists
1037,14027.0,60,6,104.82,1,2,1,4,Lost Customers
1038,14029.0,62,15,467.66,1,2,1,4,Lost Customers
1039,14030.0,17,243,2360.09,3,1,1,5,At Risk
1040,14031.0,6,257,14698.91,5,1,1,7,Potential Loyalists
1041,14032.0,1,152,2929.84,5,1,1,7,Potential Loyalists
1042,14034.0,21,92,512.02,3,1,1,5,At Risk
1043,14035.0,28,66,1428.02,3,1,1,5,At Risk
1044,14036.0,284,38,626.65,1,5,2,8,Loyal Customers
1045,14037.0,175,28,147.20000000000002,1,5,2,8,Loyal Customers
1046,14038.0,77,93,1554.48,1,3,1,5,At Risk
1047,14039.0,32,6,152.2,2,1,1,4,Lost Customers
1048,14040.0,40,240,3546.2400000000002,2,1,1,4,Lost Customers
1049,14041.0,265,21,141.41,1,5,2,8,Loyal Customers
1050,14044.0,26,209,652.82,3,1,1,5,At Risk
1051,14045.0,108,6,1659.75,1,4,2,7,Potential Loyalists
1052,14046.0,283,13,151.59,1,5,2,8,Loyal Customers
1053,14047.0,8,34,1290.01,4,1,1,6,Potential Loyalists
1054,14048.0,276,88,375.13,1,5,2,8,Loyal Customers
1055,14049.0,16,505,5639.15,3,1,1,5,At Risk
1056,14050.0,31,54,746.36,2,1,1,4,Lost Customers
1057,14051.0,0,215,15477.34,5,1,1,7,Potential Loyalists
1058,14052.0,19,56,225.36,3,1,1,5,At Risk
1059,14053.0,123,4,260.25,1,4,2,7,Potential Loyalists
1060,14054.0,64,6,92.46000000000001,1,2,1,4,Lost Customers
1061,14055.0,105,10,725.6400000000001,1,4,2,7,Potential Loyalists
1062,14056.0,0,1127,8125.24,5,1,1,7,Potential Loyalists
1063,14057.0,23,291,6147.4,3,1,1,5,At Risk
1064,14059.0,266,8,183.6,1,5,2,8,Loyal Customers
1065,14060.0,4,203,6135.38,5,1,1,7,Potential Loyalists
1066,14062.0,9,111,10464.85,4,1,1,6,Potential Loyalists
1067,14064.0,28,82,1188.32,3,1,1,5,At Risk
1068,14066.0,266,7,152.55,1,5,2,8,Loyal Customers
1069,14067.0,63,52,374.7,1,2,1,4,Lost Customers
1070,14068.0,319,24,265.85,1,5,3,9,Best Customers
1071,14071.0,3,331,1292.59,5,1,1,7,Potential Loyalists
1072,14073.0,20,14,139.54,3,1,1,5,At Risk
1073,14075.0,4,43,942.26,5,1,1,7,Potential Loyalists
1074,14076.0,128,46,122.47,1,4,2,7,Potential Loyalists
1075,14077.0,40,42,499.42,2,1,1,4,Lost Customers
1076,14078.0,101,65,1049.37,1,3,2,6,Potential Loyalists
1077,14079.0,124,12,375.1,1,4,2,7,Potential Loyalists
1078,14080.0,32,4,45.599999999999994,2,1,1,4,Lost Customers
1079,14081.0,266,156,904.67,1,5,2,8,Loyal Customers
1080,14082.0,364,29,182.25,1,5,3,9,Best Customers
1081,14083.0,3,181,1018.43,5,1,1,7,Potential Loyalists
1082,14085.0,1,451,4435.79,5,1,1,7,Potential Loyalists
1083,14087.0,2,70,181.67,5,1,1,7,Potential Loyalists
1084,14088.0,9,590,50415.49,4,1,1,6,Potential Loyalists
1085,14089.0,56,14,161.0,1,2,1,4,Lost Customers
1086,14090.0,324,1,76.32000000000001,1,5,3,9,Best Customers
1087,14092.0,7,217,4063.1,5,1,1,7,Potential Loyalists
1088,14093.0,11,105,442.85,4,1,1,6,Potential Loyalists
1089,14096.0,3,5095,53258.43,5,1,1,7,Potential Loyalists
1090,14098.0,36,21,147.35,2,1,1,4,Lost Customers
1091,14099.0,15,252,3092.9700000000003,3,1,1,5,At Risk
1092,14100.0,137,26,194.9,1,4,2,7,Potential Loyalists
1093,14101.0,73,35,5976.79,1,2,1,4,Lost Customers
1094,14102.0,4,84,1314.73,5,1,1,7,Potential Loyalists
1095,14104.0,154,21,216.21,1,5,2,8,Loyal Customers
1096,14105.0,84,76,1260.33,1,3,1,5,At Risk
1097,14107.0,51,124,2688.48,1,2,1,4,Lost Customers
1098,14108.0,30,35,594.16,3,1,1,5,At Risk
1099,14109.0,22,14,80.2,3,1,1,5,At Risk
1100,14110.0,3,157,5669.65,5,1,1,7,Potential Loyalists
1101,14111.0,13,11,688.6,4,1,1,6,Potential Loyalists
1102,14112.0,22,173,2774.17,3,1,1,5,At Risk
1103,14113.0,3,40,1377.92,5,1,1,7,Potential Loyalists
1104,14114.0,273,15,386.53,1,5,2,8,Loyal Customers
1105,14116.0,19,72,1382.74,3,1,1,5,At Risk
1106,14117.0,143,3,90.0,1,4,2,7,Potential Loyalists
1108,14121.0,3,161,2740.3,5,1,1,7,Potential Loyalists
1109,14124.0,83,5,419.58,1,3,1,5,At Risk
1110,14125.0,10,167,2740.43,4,1,1,6,Potential Loyalists
1111,14126.0,7,16,643.6300000000001,5,1,1,7,Potential Loyalists
1112,14127.0,122,44,709.71,1,4,2,7,Potential Loyalists
1113,14128.0,60,46,637.5,1,2,1,4,Lost Customers
1114,14129.0,1,52,1123.8600000000001,5,1,1,7,Potential Loyalists
1115,14130.0,318,67,483.86,1,5,3,9,Best Customers
1116,14132.0,1,201,3580.13,5,1,1,7,Potential Loyalists
1117,14133.0,129,30,590.34,1,4,2,7,Potential Loyalists
1118,14135.0,1,134,4690.31,5,1,1,7,Potential Loyalists
1119,14138.0,1,47,982.38,5,1,1,7,Potential Loyalists
1120,14139.0,45,26,415.82,2,2,1,5,At Risk
1121,14140.0,3,67,920.05,5,1,1,7,Potential Loyalists
1122,14141.0,2,46,879.0300000000001,5,1,1,7,Potential Loyalists
1123,14142.0,372,22,311.81,1,5,3,9,Best Customers
1124,14143.0,133,7,115.8,1,4,2,7,Potential Loyalists
1125,14145.0,46,12,3148.2,2,2,1,5,At Risk
1126,14146.0,8,245,2949.57,4,1,1,6,Potential Loyalists
1127,14147.0,48,6,468.4,1,2,1,4,Lost Customers
1128,14148.0,233,3,157.2,1,5,2,8,Loyal Customers
1129,14149.0,212,40,259.43,1,5,2,8,Loyal Customers
1130,14150.0,35,26,658.64,2,1,1,4,Lost Customers
1131,14152.0,74,50,611.09,1,2,1,4,Lost Customers
1132,14154.0,238,52,1345.62,1,5,2,8,Loyal Customers
1133,14155.0,265,6,118.75,1,5,2,8,Loyal Customers
1134,14156.0,9,1419,114505.32,4,1,1,6,Potential Loyalists
1135,14157.0,19,49,400.43,3,1,1,5,At Risk
1136,14158.0,39,41,507.65999999999997,2,1,1,4,Lost Customers
1137,14159.0,19,1211,4675.93,3,1,1,5,At Risk
1138,14161.0,215,108,1110.52,1,5,2,8,Loyal Customers
1139,14162.0,173,25,289.36,1,5,2,8,Loyal Customers
1140,14163.0,86,52,2445.91,1,3,1,5,At Risk
1141,14164.0,70,29,1631.77,1,2,1,4,Lost Customers
1142,14165.0,275,25,122.53999999999999,1,5,2,8,Loyal Customers
1143,14167.0,38,52,574.84,2,1,1,4,Lost Customers
1144,14171.0,97,58,363.79,1,3,1,5,At Risk
1145,14173.0,10,29,450.84,4,1,1,6,Potential Loyalists
1146,14174.0,32,26,134.46,2,1,1,4,Lost Customers
1147,14175.0,50,164,3108.06,1,2,1,4,Lost Customers
1148,14176.0,296,32,574.0,1,5,2,8,Loyal Customers
1149,14177.0,84,43,554.46,1,3,1,5,At Risk
1150,14178.0,8,325,1600.93,4,1,1,6,Potential Loyalists
1151,14179.0,40,165,719.78,2,1,1,4,Lost Customers
1152,14180.0,10,248,4640.77,4,1,1,6,Potential Loyalists
1153,14184.0,66,24,452.89,1,2,1,4,Lost Customers
1154,14185.0,330,3,197.65,1,5,3,9,Best Customers
1155,14188.0,8,71,2018.91,4,1,1,6,Potential Loyalists
1156,14189.0,1,277,4604.31,5,1,1,7,Potential Loyalists
1157,14191.0,1,263,4660.01,5,1,1,7,Potential Loyalists
1158,14193.0,67,42,853.39,1,2,1,4,Lost Customers
1159,14194.0,4,604,11216.75,5,1,1,7,Potential Loyalists
1160,14195.0,201,8,962.7,1,5,2,8,Loyal Customers
1161,14196.0,106,6,335.52,1,4,2,7,Potential Loyalists
1162,14198.0,3,44,663.5,5,1,1,7,Potential Loyalists
1163,14199.0,217,2,185.39999999999998,1,5,2,8,Loyal Customers
1164,14201.0,59,39,688.04,1,2,1,4,Lost Customers
1165,14204.0,1,44,161.03,5,1,1,7,Potential Loyalists
1166,14205.0,16,38,228.5,3,1,1,5,At Risk
1167,14206.0,238,21,308.26,1,5,2,8,Loyal Customers
1168,14208.0,94,10,151.74,1,3,1,5,At Risk
1169,14209.0,10,88,2067.13,4,1,1,6,Potential Loyalists
1170,14210.0,90,103,1900.89,1,3,1,5,At Risk
1171,14211.0,52,118,2208.3,1,2,1,4,Lost Customers
1172,14212.0,89,9,1070.48,1,3,1,5,At Risk
1174,14214.0,30,70,1000.23,3,1,1,5,At Risk
1175,14215.0,11,109,1777.92,4,1,1,6,Potential Loyalists
1176,14216.0,2,59,1839.3,5,1,1,7,Potential Loyalists
1177,14217.0,1,107,1925.3600000000001,5,1,1,7,Potential Loyalists
1178,14218.0,42,12,169.48000000000002,2,2,1,5,At Risk
1179,14219.0,3,7,89.94,5,1,1,7,Potential Loyalists
1180,14220.0,246,21,632.4,1,5,2,8,Loyal Customers
1181,14221.0,41,194,3427.85,2,1,1,4,Lost Customers
1182,14222.0,176,41,683.17,1,5,2,8,Loyal Customers
1183,14223.0,91,61,975.23,1,3,1,5,At Risk
1184,14224.0,109,118,1050.1200000000001,1,4,2,7,Potential Loyalists
1185,14226.0,28,73,2201.64,3,1,1,5,At Risk
1186,14227.0,25,183,3315.71,3,1,1,5,At Risk
1187,14229.0,51,43,1450.6,1,2,1,4,Lost Customers
1188,14231.0,178,54,822.0600000000001,1,5,2,8,Loyal Customers
1189,14232.0,31,118,2043.93,2,1,1,4,Lost Customers
1190,14233.0,43,36,1447.51,2,2,1,5,At Risk
1191,14234.0,21,159,775.46,3,1,1,5,At Risk
1192,14235.0,9,80,3093.86,4,1,1,6,Potential Loyalists
1193,14236.0,80,15,490.86,1,3,1,5,At Risk
1194,14237.0,372,9,161.0,1,5,3,9,Best Customers
1195,14238.0,325,8,146.85,1,5,3,9,Best Customers
1196,14239.0,42,116,2323.5,2,2,1,5,At Risk
1197,14240.0,29,42,890.34,3,1,1,5,At Risk
1198,14241.0,183,10,213.70000000000002,1,5,2,8,Loyal Customers
1199,14242.0,234,16,280.55,1,5,2,8,Loyal Customers
1200,14243.0,8,148,2535.88,4,1,1,6,Potential Loyalists
1201,14245.0,175,112,1677.48,1,5,2,8,Loyal Customers
1202,14246.0,110,75,1474.06,1,4,2,7,Potential Loyalists
1203,14247.0,277,20,136.77,1,5,2,8,Loyal Customers
1204,14248.0,317,8,302.58,1,5,3,9,Best Customers
1205,14250.0,6,111,1904.05,5,1,1,7,Potential Loyalists
1206,14251.0,1,78,2879.7000000000003,5,1,1,7,Potential Loyalists
1207,14256.0,253,54,935.0600000000001,1,5,2,8,Loyal Customers
1208,14257.0,50,107,3087.27,1,2,1,4,Lost Customers
1209,14258.0,8,112,12650.08,4,1,1,6,Potential Loyalists
1210,14259.0,141,5,120.0,1,4,2,7,Potential Loyalists
1211,14261.0,50,52,1163.45,1,2,1,4,Lost Customers
1212,14262.0,7,143,2618.23,5,1,1,7,Potential Loyalists
1213,14264.0,154,19,319.47,1,5,2,8,Loyal Customers
1214,14267.0,150,66,1279.09,1,5,2,8,Loyal Customers
1215,14270.0,331,29,492.65000000000003,1,5,3,9,Best Customers
1216,14271.0,225,10,112.32000000000001,1,5,2,8,Loyal Customers
1217,14272.0,73,33,437.96,1,2,1,4,Lost Customers
1218,14273.0,50,29,559.97,1,2,1,4,Lost Customers
1219,14276.0,87,75,1019.39,1,3,1,5,At Risk
1220,14277.0,14,227,3921.0,4,1,1,6,Potential Loyalists
1221,14280.0,196,8,134.04,1,5,2,8,Loyal Customers
1222,14282.0,2,156,3729.34,5,1,1,7,Potential Loyalists
1223,14284.0,30,34,578.45,3,1,1,5,At Risk
1224,14285.0,20,27,1910.01,3,1,1,5,At Risk
1225,14286.0,23,285,4595.81,3,1,1,5,At Risk
1226,14287.0,7,10,156.23,5,1,1,7,Potential Loyalists
1227,14288.0,211,17,413.85,1,5,2,8,Loyal Customers
1228,14289.0,8,47,911.26,4,1,1,6,Potential Loyalists
1229,14290.0,10,103,2307.45,4,1,1,6,Potential Loyalists
1230,14291.0,1,238,3873.3,5,1,1,7,Potential Loyalists
1231,14292.0,7,108,4819.33,5,1,1,7,Potential Loyalists
1232,14293.0,2,61,1046.56,5,1,1,7,Potential Loyalists
1233,14295.0,39,6,157.70000000000002,2,1,1,4,Lost Customers
1234,14297.0,17,63,1290.48,3,1,1,5,At Risk
1235,14298.0,2,1640,50862.44,5,1,1,7,Potential Loyalists
1236,14299.0,7,162,2855.35,5,1,1,7,Potential Loyalists
1237,14300.0,18,3,43.2,3,1,1,5,At Risk
1238,14301.0,107,16,632.04,1,4,2,7,Potential Loyalists
1239,14304.0,222,27,197.1,1,5,2,8,Loyal Customers
1240,14305.0,70,110,1803.76,1,2,1,4,Lost Customers
1241,14306.0,50,35,2083.42,1,2,1,4,Lost Customers
1242,14307.0,88,180,2995.72,1,3,1,5,At Risk
1243,14309.0,7,123,2319.68,5,1,1,7,Potential Loyalists
1244,14311.0,224,27,229.71,1,5,2,8,Loyal Customers
1245,14312.0,46,87,1611.59,2,2,1,5,At Risk
1246,14314.0,106,8,120.0,1,4,2,7,Potential Loyalists
1247,14315.0,20,104,2456.98,3,1,1,5,At Risk
1248,14317.0,64,24,508.58,1,2,1,4,Lost Customers
1249,14320.0,206,42,343.11,1,5,2,8,Loyal Customers
1250,14321.0,10,123,1530.75,4,1,1,6,Potential Loyalists
1251,14323.0,114,41,574.26,1,4,2,7,Potential Loyalists
1252,14326.0,234,9,166.85,1,5,2,8,Loyal Customers
1253,14327.0,162,12,311.65,1,5,2,8,Loyal Customers
1254,14329.0,8,269,4928.74,4,1,1,6,Potential Loyalists
1255,14331.0,123,28,462.65999999999997,1,4,2,7,Potential Loyalists
1256,14332.0,22,26,866.3100000000001,3,1,1,5,At Risk
1257,14333.0,63,19,351.45,1,2,1,4,Lost Customers
1258,14334.0,16,163,2539.46,3,1,1,5,At Risk
1259,14335.0,15,63,468.26,3,1,1,5,At Risk
1260,14336.0,16,90,1614.91,3,1,1,5,At Risk
1261,14338.0,157,34,554.22,1,5,2,8,Loyal Customers
1262,14339.0,234,17,293.73,1,5,2,8,Loyal Customers
1263,14340.0,218,6,134.7,1,5,2,8,Loyal Customers
1264,14341.0,44,130,2166.38,2,2,1,5,At Risk
1265,14342.0,20,23,608.71,3,1,1,5,At Risk
1266,14344.0,126,71,889.9300000000001,1,4,2,7,Potential Loyalists
1267,14345.0,38,6,108.97999999999999,2,1,1,4,Lost Customers
1268,14346.0,120,60,1021.58,1,4,2,7,Potential Loyalists
1269,14348.0,259,18,409.57,1,5,2,8,Loyal Customers
1270,14349.0,9,31,133.5,4,1,1,6,Potential Loyalists
1271,14350.0,270,21,258.7,1,5,2,8,Loyal Customers
1272,14351.0,164,1,51.0,1,5,2,8,Loyal Customers
1273,14352.0,156,47,1078.96,1,5,2,8,Loyal Customers
1274,14353.0,214,6,90.6,1,5,2,8,Loyal Customers
1275,14354.0,5,9,163.62,5,1,1,7,Potential Loyalists
1276,14355.0,365,11,174.4,1,5,3,9,Best Customers
1277,14356.0,59,38,666.9399999999999,1,2,1,4,Lost Customers
1278,14357.0,42,41,225.77,2,2,1,5,At Risk
1279,14359.0,18,58,882.58,3,1,1,5,At Risk
1280,14360.0,31,118,2128.23,2,1,1,4,Lost Customers
1281,14362.0,21,41,161.2,3,1,1,5,At Risk
1282,14364.0,108,69,3717.35,1,4,2,7,Potential Loyalists
1283,14367.0,7,533,9167.82,5,1,1,7,Potential Loyalists
1284,14368.0,319,8,155.0,1,5,3,9,Best Customers
1285,14371.0,294,4,100.5,1,5,2,8,Loyal Customers
1286,14373.0,357,4,76.55,1,5,3,9,Best Customers
1287,14375.0,184,75,257.68,1,5,2,8,Loyal Customers
1288,14377.0,190,11,617.05,1,5,2,8,Loyal Customers
1289,14379.0,43,46,348.1,2,2,1,5,At Risk
1290,14381.0,51,56,202.68,1,2,1,4,Lost Customers
1291,14382.0,25,131,626.07,3,1,1,5,At Risk
1292,14383.0,37,59,1247.69,2,1,1,4,Lost Customers
1293,14385.0,8,14,202.10999999999999,4,1,1,6,Potential Loyalists
1294,14386.0,296,7,142.4,1,5,2,8,Loyal Customers
1295,14387.0,32,140,1770.56,2,1,1,4,Lost Customers
1296,14388.0,8,191,3172.04,4,1,1,6,Potential Loyalists
1297,14389.0,8,62,999.72,4,1,1,6,Potential Loyalists
1298,14390.0,9,291,4592.47,4,1,1,6,Potential Loyalists
1299,14393.0,217,5,67.95,1,5,2,8,Loyal Customers
1300,14395.0,1,353,3471.91,5,1,1,7,Potential Loyalists
1301,14396.0,64,73,487.99,1,2,1,4,Lost Customers
1302,14397.0,0,95,2556.68,5,1,1,7,Potential Loyalists
1303,14400.0,140,26,559.7,1,4,2,7,Potential Loyalists
1304,14401.0,3,183,4039.98,5,1,1,7,Potential Loyalists
1305,14403.0,129,26,1426.31,1,4,2,7,Potential Loyalists
1306,14404.0,33,104,1434.72,2,1,1,4,Lost Customers
1307,14406.0,118,8,156.75,1,4,2,7,Potential Loyalists
1308,14407.0,106,75,2096.08,1,4,2,7,Potential Loyalists
1309,14408.0,10,107,2606.53,4,1,1,6,Potential Loyalists
1310,14409.0,70,55,1908.25,1,2,1,4,Lost Customers
1311,14410.0,15,285,590.3,3,1,1,5,At Risk
1312,14411.0,310,14,1063.0,1,5,3,9,Best Customers
1313,14412.0,34,45,761.3299999999999,2,1,1,4,Lost Customers
1314,14413.0,361,23,122.7,1,5,3,9,Best Customers
1315,14414.0,91,98,1485.1299999999999,1,3,1,5,At Risk
1316,14415.0,0,612,5811.56,5,1,1,7,Potential Loyalists
1317,14416.0,21,14,490.22,3,1,1,5,At Risk
1318,14418.0,3,124,1937.25,5,1,1,7,Potential Loyalists
1319,14419.0,10,206,1058.06,4,1,1,6,Potential Loyalists
1320,14420.0,84,30,385.87,1,3,1,5,At Risk
1321,14421.0,56,27,813.11,1,2,1,4,Lost Customers
1322,14422.0,0,222,4263.64,5,1,1,7,Potential Loyalists
1323,14423.0,217,3,265.2,1,5,2,8,Loyal Customers
1324,14424.0,17,1,322.08,3,1,1,5,At Risk
1325,14426.0,18,264,3918.9,3,1,1,5,At Risk
1326,14427.0,49,17,363.34000000000003,1,2,1,4,Lost Customers
1327,14428.0,6,148,1230.14,5,1,1,7,Potential Loyalists
1328,14431.0,298,22,397.76000000000005,1,5,2,8,Loyal Customers
1329,14432.0,9,382,2255.51,4,1,1,6,Potential Loyalists
1330,14434.0,21,12,1372.8,3,1,1,5,At Risk
1331,14436.0,98,9,89.06,1,3,1,5,At Risk
1332,14437.0,365,5,63.0,1,5,3,9,Best Customers
1333,14438.0,305,9,131.9,1,5,3,9,Best Customers
1334,14440.0,7,55,2357.68,5,1,1,7,Potential Loyalists
1335,14441.0,0,59,1545.14,5,1,1,7,Potential Loyalists
1336,14443.0,53,98,1400.88,1,2,1,4,Lost Customers
1337,14446.0,0,292,1034.78,5,1,1,7,Potential Loyalists
1338,14447.0,18,70,1163.23,3,1,1,5,At Risk
1339,14448.0,8,20,375.35,4,1,1,6,Potential Loyalists
1340,14449.0,18,258,907.1,3,1,1,5,At Risk
1341,14450.0,180,40,483.25,1,5,2,8,Loyal Customers
1342,14451.0,59,109,662.59,1,2,1,4,Lost Customers
1343,14452.0,10,62,264.44,4,1,1,6,Potential Loyalists
1344,14453.0,189,22,119.93,1,5,2,8,Loyal Customers
1345,14456.0,4,974,3045.92,5,1,1,7,Potential Loyalists
1346,14457.0,310,4,113.64,1,5,3,9,Best Customers
1347,14459.0,154,37,1837.92,1,5,2,8,Loyal Customers
1348,14460.0,109,17,383.34,1,4,2,7,Potential Loyalists
1349,14461.0,147,179,2102.67,1,4,2,7,Potential Loyalists
1350,14462.0,63,244,1965.9,1,2,1,4,Lost Customers
1351,14463.0,97,6,529.62,1,3,1,5,At Risk
1352,14465.0,246,130,1058.6200000000001,1,5,2,8,Loyal Customers
1353,14466.0,28,72,2272.4,3,1,1,5,At Risk
1354,14467.0,17,90,598.76,3,1,1,5,At Risk
1355,14470.0,11,43,461.19,4,1,1,6,Potential Loyalists
1356,14472.0,103,281,1936.84,1,4,2,7,Potential Loyalists
1357,14473.0,73,7,234.34,1,2,1,4,Lost Customers
1358,14474.0,42,30,537.71,2,2,1,5,At Risk
1359,14475.0,71,47,799.82,1,2,1,4,Lost Customers
1360,14476.0,256,19,215.7,1,5,2,8,Loyal Customers
1361,14477.0,19,11,1307.81,3,1,1,5,At Risk
1362,14479.0,253,18,316.25,1,5,2,8,Loyal Customers
1363,14480.0,10,13,279.05,4,1,1,6,Potential Loyalists
1364,14481.0,164,30,636.51,1,5,2,8,Loyal Customers
1365,14482.0,17,144,2068.15,3,1,1,5,At Risk
1366,14483.0,149,10,129.20000000000002,1,4,2,7,Potential Loyalists
1367,14484.0,49,14,321.92,1,2,1,4,Lost Customers
1368,14485.0,38,47,165.75,2,1,1,4,Lost Customers
1369,14487.0,26,145,1183.58,3,1,1,5,At Risk
1370,14488.0,50,49,1047.43,1,2,1,4,Lost Customers
1371,14489.0,206,30,463.38,1,5,2,8,Loyal Customers
1372,14491.0,174,17,340.93,1,5,2,8,Loyal Customers
1373,14493.0,6,123,2362.84,5,1,1,7,Potential Loyalists
1374,14494.0,25,7,139.56,3,1,1,5,At Risk
1375,14495.0,50,6,123.8,1,2,1,4,Lost Customers
1376,14496.0,311,19,538.8100000000001,1,5,3,9,Best Customers
1377,14497.0,300,31,457.47,1,5,3,9,Best Customers
1378,14498.0,42,193,1957.32,2,2,1,5,At Risk
1379,14499.0,25,194,815.32,3,1,1,5,At Risk
1380,14500.0,87,7,356.85,1,3,1,5,At Risk
1381,14501.0,63,12,190.31,1,2,1,4,Lost Customers
1382,14502.0,19,630,2347.98,3,1,1,5,At Risk
1383,14503.0,2,164,3543.26,5,1,1,7,Potential Loyalists
1384,14504.0,46,107,673.26,2,2,1,5,At Risk
1385,14505.0,16,803,5818.7,3,1,1,5,At Risk
1386,14506.0,16,316,2012.17,3,1,1,5,At Risk
1387,14507.0,23,98,1368.18,3,1,1,5,At Risk
1388,14508.0,21,57,276.42,3,1,1,5,At Risk
1389,14511.0,10,71,1267.41,4,1,1,6,Potential Loyalists
1390,14512.0,187,23,275.28,1,5,2,8,Loyal Customers
1391,14513.0,100,18,438.49,1,3,2,6,Potential Loyalists
1392,14514.0,60,73,1055.35,1,2,1,4,Lost Customers
1393,14515.0,17,101,2102.09,3,1,1,5,At Risk
1394,14517.0,32,18,330.45,2,1,1,4,Lost Customers
1395,14518.0,63,16,174.37,1,2,1,4,Lost Customers
1396,14520.0,1,4,270.6,5,1,1,7,Potential Loyalists
1397,14522.0,23,17,974.54,3,1,1,5,At Risk
1398,14523.0,107,12,241.09,1,4,2,7,Potential Loyalists
1399,14524.0,31,203,1867.68,2,1,1,4,Lost Customers
1400,14525.0,8,297,4266.37,4,1,1,6,Potential Loyalists
1401,14527.0,2,974,8479.22,5,1,1,7,Potential Loyalists
1402,14528.0,36,18,364.21999999999997,2,1,1,4,Lost Customers
1403,14529.0,59,229,620.04,1,2,1,4,Lost Customers
1404,14530.0,25,216,2925.91,3,1,1,5,At Risk
1405,14532.0,235,64,932.85,1,5,2,8,Loyal Customers
1406,14533.0,24,65,1812.62,3,1,1,5,At Risk
1407,14534.0,2,557,4073.7000000000003,5,1,1,7,Potential Loyalists
1408,14535.0,58,333,2841.09,1,2,1,4,Lost Customers
1409,14536.0,259,19,171.8,1,5,2,8,Loyal Customers
1410,14537.0,57,10,355.56,1,2,1,4,Lost Customers
1411,14538.0,64,19,388.25,1,2,1,4,Lost Customers
1412,14539.0,15,32,537.48,3,1,1,5,At Risk
1413,14540.0,9,76,996.26,4,1,1,6,Potential Loyalists
1414,14541.0,58,111,1461.65,1,2,1,4,Lost Customers
1415,14542.0,185,5,103.25,1,5,2,8,Loyal Customers
1416,14543.0,3,100,2945.22,5,1,1,7,Potential Loyalists
1417,14544.0,23,114,2024.45,3,1,1,5,At Risk
1418,14546.0,3,417,2487.02,5,1,1,7,Potential Loyalists
1419,14547.0,3,367,3986.7400000000002,5,1,1,7,Potential Loyalists
1420,14548.0,150,4,652.8,1,5,2,8,Loyal Customers
1421,14549.0,310,56,289.24,1,5,3,9,Best Customers
1422,14550.0,10,48,765.62,4,1,1,6,Potential Loyalists
1423,14551.0,17,10,186.23,3,1,1,5,At Risk
1424,14552.0,151,58,165.07,1,5,2,8,Loyal Customers
1425,14553.0,18,113,859.27,3,1,1,5,At Risk
1426,14554.0,9,216,2381.04,4,1,1,6,Potential Loyalists
1427,14555.0,56,21,324.14,1,2,1,4,Lost Customers
1429,14560.0,6,76,2174.18,5,1,1,7,Potential Loyalists
1430,14561.0,75,69,1080.76,1,3,1,5,At Risk
1431,14562.0,3,445,4715.52,5,1,1,7,Potential Loyalists
1432,14565.0,95,129,3073.77,1,3,1,5,At Risk
1433,14567.0,34,34,1524.46,2,1,1,4,Lost Customers
1434,14569.0,0,12,227.39,5,1,1,7,Potential Loyalists
1435,14570.0,280,28,217.21,1,5,2,8,Loyal Customers
1436,14572.0,2,273,2803.69,5,1,1,7,Potential Loyalists
1437,14573.0,179,241,1603.72,1,5,2,8,Loyal Customers
1438,14576.0,371,1,35.400000000000006,1,5,3,9,Best Customers
1439,14577.0,12,123,859.71,4,1,1,6,Potential Loyalists
1440,14578.0,2,24,168.63,5,1,1,7,Potential Loyalists
1441,14581.0,16,17,138.6,3,1,1,5,At Risk
1442,14582.0,40,6,114.11,2,1,1,4,Lost Customers
1443,14583.0,5,330,1052.55,5,1,1,7,Potential Loyalists
1444,14584.0,168,101,1029.26,1,5,2,8,Loyal Customers
1445,14585.0,49,29,157.05,1,2,1,4,Lost Customers
1446,14586.0,226,27,134.16,1,5,2,8,Loyal Customers
1447,14587.0,18,384,1598.24,3,1,1,5,At Risk
1448,14589.0,371,3,39.75,1,5,3,9,Best Customers
1449,14591.0,14,197,1447.14,4,1,1,6,Potential Loyalists
1450,14592.0,34,164,570.46,2,1,1,4,Lost Customers
1451,14593.0,21,152,617.99,3,1,1,5,At Risk
1452,14594.0,6,53,379.83,5,1,1,7,Potential Loyalists
1453,14595.0,19,102,1740.6,3,1,1,5,At Risk
1454,14597.0,10,55,883.15,4,1,1,6,Potential Loyalists
1455,14598.0,43,50,221.97,2,2,1,5,At Risk
1456,14600.0,305,25,393.33000000000004,1,5,3,9,Best Customers
1457,14601.0,10,7,213.96,4,1,1,6,Potential Loyalists
1458,14603.0,274,2,660.0,1,5,2,8,Loyal Customers
1459,14606.0,0,2778,11567.1,5,1,1,7,Potential Loyalists
1460,14607.0,15,106,9793.1,3,1,1,5,At Risk
1461,14608.0,3,20,1785.15,5,1,1,7,Potential Loyalists
1462,14609.0,71,4,601.56,1,2,1,4,Lost Customers
1463,14616.0,242,3,406.08000000000004,1,5,2,8,Loyal Customers
1464,14618.0,8,17,538.59,4,1,1,6,Potential Loyalists
1465,14619.0,238,22,379.51,1,5,2,8,Loyal Customers
1466,14620.0,203,30,393.28000000000003,1,5,2,8,Loyal Customers
1467,14621.0,0,96,1765.76,5,1,1,7,Potential Loyalists
1468,14622.0,184,21,320.58000000000004,1,5,2,8,Loyal Customers
1469,14623.0,31,134,864.6700000000001,2,1,1,4,Lost Customers
1470,14624.0,56,13,225.85,1,2,1,4,Lost Customers
1471,14625.0,184,57,848.48,1,5,2,8,Loyal Customers
1472,14626.0,8,126,2757.07,4,1,1,6,Potential Loyalists
1474,14628.0,90,24,671.96,1,3,1,5,At Risk
1475,14629.0,3,153,939.21,5,1,1,7,Potential Loyalists
1476,14631.0,50,41,1006.98,1,2,1,4,Lost Customers
1477,14632.0,262,8,114.56,1,5,2,8,Loyal Customers
1478,14633.0,265,20,344.90000000000003,1,5,2,8,Loyal Customers
1479,14636.0,35,28,609.85,2,1,1,4,Lost Customers
1480,14638.0,50,16,443.6,1,2,1,4,Lost Customers
1481,14639.0,51,175,2952.34,1,2,1,4,Lost Customers
1482,14640.0,15,113,2042.15,3,1,1,5,At Risk
1483,14641.0,21,7,110.46,3,1,1,5,At Risk
1484,14642.0,58,2,96.12,1,2,1,4,Lost Customers
1485,14643.0,169,34,668.61,1,5,2,8,Loyal Customers
1486,14644.0,8,29,780.46,4,1,1,6,Potential Loyalists
1487,14645.0,156,30,597.09,1,5,2,8,Loyal Customers
1488,14647.0,200,30,243.22,1,5,2,8,Loyal Customers
1489,14649.0,4,199,1417.29,5,1,1,7,Potential Loyalists
1490,14651.0,66,102,654.6,1,2,1,4,Lost Customers
1491,14652.0,76,29,114.18,1,3,1,5,At Risk
1492,14653.0,0,236,1937.6,5,1,1,7,Potential Loyalists
1493,14655.0,3,50,1930.15,5,1,1,7,Potential Loyalists
1494,14656.0,168,80,291.05,1,5,2,8,Loyal Customers
1495,14657.0,17,127,838.27,3,1,1,5,At Risk
1496,14658.0,4,29,247.15,5,1,1,7,Potential Loyalists
1497,14659.0,8,259,2456.53,4,1,1,6,Potential Loyalists
1498,14660.0,86,30,285.74,1,3,1,5,At Risk
1499,14661.0,26,4,107.95,3,1,1,5,At Risk
1500,14662.0,28,168,771.17,3,1,1,5,At Risk
1501,14664.0,19,99,637.89,3,1,1,5,At Risk
1502,14665.0,60,117,1258.38,1,2,1,4,Lost Customers
1503,14666.0,23,13,179.95,3,1,1,5,At Risk
1504,14667.0,10,575,9226.95,4,1,1,6,Potential Loyalists
1505,14669.0,241,170,1269.99,1,5,2,8,Loyal Customers
1506,14670.0,279,132,411.53,1,5,2,8,Loyal Customers
1507,14672.0,234,61,765.5500000000001,1,5,2,8,Loyal Customers
1508,14673.0,2,74,1736.4,5,1,1,7,Potential Loyalists
1509,14675.0,15,102,604.75,3,1,1,5,At Risk
1510,14676.0,30,44,2543.2400000000002,3,1,1,5,At Risk
1512,14680.0,24,320,26932.34,3,1,1,5,At Risk
1513,14681.0,70,7,498.95,1,2,1,4,Lost Customers
1514,14682.0,187,2,52.0,1,5,2,8,Loyal Customers
1515,14684.0,25,421,1236.28,3,1,1,5,At Risk
1516,14687.0,106,15,628.38,1,4,2,7,Potential Loyalists
1517,14688.0,7,359,5107.38,5,1,1,7,Potential Loyalists
1518,14689.0,208,13,112.80000000000001,1,5,2,8,Loyal Customers
1519,14690.0,43,54,358.61,2,2,1,5,At Risk
1520,14691.0,30,71,2114.33,3,1,1,5,At Risk
1521,14692.0,136,69,582.05,1,4,2,7,Potential Loyalists
1522,14693.0,264,8,172.9,1,5,2,8,Loyal Customers
1523,14696.0,3,133,2070.97,5,1,1,7,Potential Loyalists
1524,14697.0,217,22,188.61,1,5,2,8,Loyal Customers
1525,14698.0,1,210,1250.76,5,1,1,7,Potential Loyalists
1526,14699.0,213,8,109.13000000000001,1,5,2,8,Loyal Customers
1527,14700.0,31,115,2235.3,2,1,1,4,Lost Customers
1528,14701.0,10,350,2486.2200000000003,4,1,1,6,Potential Loyalists
1529,14702.0,0,348,3250.64,5,1,1,7,Potential Loyalists
1530,14703.0,14,22,318.17,4,1,1,6,Potential Loyalists
1531,14704.0,19,412,1514.57,3,1,1,5,At Risk
1532,14705.0,198,1,179.0,1,5,2,8,Loyal Customers
1533,14708.0,2,29,1096.67,5,1,1,7,Potential Loyalists
1534,14709.0,14,197,4911.14,4,1,1,6,Potential Loyalists
1535,14710.0,13,139,606.13,4,1,1,6,Potential Loyalists
1536,14711.0,9,359,2838.2,4,1,1,6,Potential Loyalists
1537,14712.0,28,25,917.07,3,1,1,5,At Risk
1538,14713.0,8,341,2664.2599999999998,4,1,1,6,Potential Loyalists
1539,14714.0,23,10,160.19,3,1,1,5,At Risk
1540,14715.0,24,71,867.38,3,1,1,5,At Risk
1541,14716.0,42,55,329.68,2,2,1,5,At Risk
1542,14719.0,1,238,1592.18,5,1,1,7,Potential Loyalists
1543,14720.0,5,37,663.81,5,1,1,7,Potential Loyalists
1544,14722.0,146,29,187.92,1,4,2,7,Potential Loyalists
1545,14723.0,9,277,1156.6,4,1,1,6,Potential Loyalists
1546,14725.0,24,52,718.08,3,1,1,5,At Risk
1547,14727.0,273,10,268.58,1,5,2,8,Loyal Customers
1548,14729.0,373,71,313.49,1,5,3,9,Best Customers
1549,14730.0,0,501,2005.06,5,1,1,7,Potential Loyalists
1550,14731.0,46,45,380.02,2,2,1,5,At Risk
1551,14732.0,7,149,2686.34,5,1,1,7,Potential Loyalists
1552,14733.0,8,216,9451.539999999999,4,1,1,6,Potential Loyalists
1553,14735.0,3,204,5792.6900000000005,5,1,1,7,Potential Loyalists
1554,14737.0,3,17,1164.55,5,1,1,7,Potential Loyalists
1555,14738.0,38,56,1289.94,2,1,1,4,Lost Customers
1556,14739.0,1,61,3899.1,5,1,1,7,Potential Loyalists
1557,14740.0,190,93,1423.21,1,5,2,8,Loyal Customers
1558,14741.0,11,59,1400.34,4,1,1,6,Potential Loyalists
1559,14744.0,15,28,1088.53,3,1,1,5,At Risk
1560,14745.0,112,70,1167.16,1,4,2,7,Potential Loyalists
1561,14747.0,247,19,294.3,1,5,2,8,Loyal Customers
1562,14748.0,28,91,1318.85,3,1,1,5,At Risk
1563,14752.0,43,5,389.64,2,2,1,5,At Risk
1564,14753.0,86,30,563.15,1,3,1,5,At Risk
1565,14754.0,44,41,638.05,2,2,1,5,At Risk
1566,14755.0,9,237,4965.38,4,1,1,6,Potential Loyalists
1567,14756.0,14,38,738.96,4,1,1,6,Potential Loyalists
1568,14757.0,74,19,420.5,1,2,1,4,Lost Customers
1569,14758.0,144,71,1484.06,1,4,2,7,Potential Loyalists
1570,14759.0,4,102,1625.97,5,1,1,7,Potential Loyalists
1571,14760.0,293,7,53.8,1,5,2,8,Loyal Customers
1572,14761.0,58,11,255.9,1,2,1,4,Lost Customers
1573,14762.0,263,21,300.52,1,5,2,8,Loyal Customers
1574,14764.0,43,7,250.55,2,2,1,5,At Risk
1575,14765.0,28,39,254.11,3,1,1,5,At Risk
1576,14766.0,7,137,2423.07,5,1,1,7,Potential Loyalists
1577,14768.0,16,6,139.5,3,1,1,5,At Risk
1578,14769.0,2,1093,10639.95,5,1,1,7,Potential Loyalists
1579,14770.0,231,52,876.42,1,5,2,8,Loyal Customers
1580,14772.0,111,9,139.26,1,4,2,7,Potential Loyalists
1581,14775.0,57,60,1011.9,1,2,1,4,Lost Customers
1582,14776.0,50,134,2195.58,1,2,1,4,Lost Customers
1584,14778.0,126,35,730.86,1,4,2,7,Potential Loyalists
1585,14779.0,280,41,386.15,1,5,2,8,Loyal Customers
1586,14780.0,54,27,447.68,1,2,1,4,Lost Customers
1587,14782.0,319,6,200.10000000000002,1,5,3,9,Best Customers
1588,14784.0,25,15,289.99,3,1,1,5,At Risk
1589,14785.0,9,3,77.4,4,1,1,6,Potential Loyalists
1590,14788.0,6,30,679.44,5,1,1,7,Potential Loyalists
1591,14789.0,28,6,197.64,3,1,1,5,At Risk
1592,14790.0,16,46,745.06,3,1,1,5,At Risk
1594,14793.0,3,15,214.14000000000001,5,1,1,7,Potential Loyalists
1595,14794.0,2,82,1272.11,5,1,1,7,Potential Loyalists
1596,14795.0,165,6,131.45000000000002,1,5,2,8,Loyal Customers
1597,14796.0,0,1164,7837.95,5,1,1,7,Potential Loyalists
1598,14798.0,52,12,173.74,1,2,1,4,Lost Customers
1599,14799.0,50,13,157.7,1,2,1,4,Lost Customers
1600,14800.0,47,392,4236.34,2,2,1,5,At Risk
1601,14801.0,60,59,193.14,1,2,1,4,Lost Customers
1602,14803.0,161,44,845.5500000000001,1,5,2,8,Loyal Customers
1603,14804.0,8,12,353.27,4,1,1,6,Potential Loyalists
1604,14805.0,14,47,554.65,4,1,1,6,Potential Loyalists
1605,14806.0,74,11,193.39000000000001,1,2,1,4,Lost Customers
1606,14808.0,39,255,2300.37,2,1,1,4,Lost Customers
1607,14810.0,40,255,2087.88,2,1,1,4,Lost Customers
1608,14813.0,369,30,155.43,1,5,3,9,Best Customers
1609,14815.0,36,53,778.5,2,1,1,4,Lost Customers
1610,14816.0,196,4,271.85,1,5,2,8,Loyal Customers
1611,14817.0,199,63,1110.34,1,5,2,8,Loyal Customers
1612,14818.0,73,48,657.8,1,2,1,4,Lost Customers
1613,14819.0,63,13,272.07,1,2,1,4,Lost Customers
1614,14820.0,20,29,507.29,3,1,1,5,At Risk
1615,14821.0,366,2,48.800000000000004,1,5,3,9,Best Customers
1616,14823.0,179,70,321.43,1,5,2,8,Loyal Customers
1617,14824.0,9,29,1127.71,4,1,1,6,Potential Loyalists
1618,14825.0,3,121,2226.9100000000003,5,1,1,7,Potential Loyalists
1619,14828.0,196,17,2139.76,1,5,2,8,Loyal Customers
1620,14829.0,28,45,644.65,3,1,1,5,At Risk
1621,14830.0,52,39,196.28,1,2,1,4,Lost Customers
1622,14834.0,17,70,1698.35,3,1,1,5,At Risk
1623,14836.0,9,6,102.44999999999999,4,1,1,6,Potential Loyalists
1624,14837.0,89,110,1641.2,1,3,1,5,At Risk
1625,14840.0,267,4,62.85,1,5,2,8,Loyal Customers
1626,14841.0,52,138,3295.76,1,2,1,4,Lost Customers
1627,14842.0,34,158,2456.8,2,1,1,4,Lost Customers
1628,14844.0,63,130,3189.81,1,2,1,4,Lost Customers
1629,14847.0,148,13,309.4,1,4,2,7,Potential Loyalists
1630,14849.0,21,392,7904.28,3,1,1,5,At Risk
1631,14850.0,311,22,278.15,1,5,3,9,Best Customers
1632,14851.0,22,28,511.35,3,1,1,5,At Risk
1633,14852.0,57,143,2836.69,1,2,1,4,Lost Customers
1634,14853.0,8,10,463.05,4,1,1,6,Potential Loyalists
1635,14854.0,77,131,2749.89,1,3,1,5,At Risk
1636,14855.0,118,20,645.65,1,4,2,7,Potential Loyalists
1637,14856.0,35,66,1311.3799999999999,2,1,1,4,Lost Customers
1638,14857.0,59,61,1165.65,1,2,1,4,Lost Customers
1639,14859.0,12,59,1352.04,4,1,1,6,Potential Loyalists
1640,14860.0,8,12,168.62,4,1,1,6,Potential Loyalists
1641,14861.0,51,6,125.79,1,2,1,4,Lost Customers
1642,14862.0,25,48,841.2,3,1,1,5,At Risk
1643,14863.0,28,11,266.76,3,1,1,5,At Risk
1644,14865.0,6,4,52.2,5,1,1,7,Potential Loyalists
1645,14866.0,10,102,14160.95,4,1,1,6,Potential Loyalists
1646,14867.0,185,37,701.33,1,5,2,8,Loyal Customers
1647,14868.0,2,147,2939.64,5,1,1,7,Potential Loyalists
1648,14869.0,3,72,721.95,5,1,1,7,Potential Loyalists
1649,14870.0,261,13,327.25,1,5,2,8,Loyal Customers
1650,14871.0,2,98,522.38,5,1,1,7,Potential Loyalists
1651,14873.0,209,28,519.68,1,5,2,8,Loyal Customers
1652,14875.0,8,49,1457.67,4,1,1,6,Potential Loyalists
1653,14878.0,12,124,1485.54,4,1,1,6,Potential Loyalists
1654,14880.0,76,47,706.19,1,3,1,5,At Risk
1655,14881.0,19,17,255.4,3,1,1,5,At Risk
1656,14882.0,26,11,589.7,3,1,1,5,At Risk
1657,14883.0,18,54,756.64,3,1,1,5,At Risk
1658,14885.0,131,15,765.3199999999999,1,4,2,7,Potential Loyalists
1659,14886.0,252,18,364.8,1,5,2,8,Loyal Customers
1660,14887.0,78,6,1862.0,1,3,1,5,At Risk
1661,14888.0,206,20,369.2,1,5,2,8,Loyal Customers
1662,14889.0,335,10,135.9,1,5,3,9,Best Customers
1663,14890.0,253,7,125.65,1,5,2,8,Loyal Customers
1664,14891.0,147,33,554.38,1,4,2,7,Potential Loyalists
1665,14893.0,9,73,1237.8500000000001,4,1,1,6,Potential Loyalists
1666,14894.0,84,23,655.75,1,3,1,5,At Risk
1667,14895.0,7,506,11020.26,5,1,1,7,Potential Loyalists
1668,14896.0,204,43,468.77000000000004,1,5,2,8,Loyal Customers
1669,14897.0,7,55,1366.38,5,1,1,7,Potential Loyalists
1670,14898.0,22,119,1228.32,3,1,1,5,At Risk
1671,14901.0,10,98,1414.99,4,1,1,6,Potential Loyalists
1672,14902.0,20,24,314.11,3,1,1,5,At Risk
1673,14903.0,20,364,2744.48,3,1,1,5,At Risk
1674,14904.0,1,69,1025.44,5,1,1,7,Potential Loyalists
1675,14905.0,153,18,599.9,1,5,2,8,Loyal Customers
1676,14907.0,2,168,3478.85,5,1,1,7,Potential Loyalists
1677,14908.0,73,9,277.8,1,2,1,4,Lost Customers
1678,14910.0,2,35,389.86,5,1,1,7,Potential Loyalists
1679,14911.0,0,5898,133007.13,5,1,1,7,Potential Loyalists
1680,14913.0,35,87,1227.43,2,1,1,4,Lost Customers
1681,14915.0,85,13,258.83,1,3,1,5,At Risk
1682,14916.0,70,79,1264.84,1,2,1,4,Lost Customers
1683,14918.0,115,45,1610.15,1,4,2,7,Potential Loyalists
1684,14920.0,212,57,977.77,1,5,2,8,Loyal Customers
1685,14921.0,29,78,1316.07,3,1,1,5,At Risk
1686,14923.0,50,44,749.1,1,2,1,4,Lost Customers
1687,14924.0,245,10,310.05,1,5,2,8,Loyal Customers
1688,14929.0,31,11,223.88,2,1,1,4,Lost Customers
1689,14944.0,29,172,5842.95,3,1,1,5,At Risk
1690,14946.0,13,3,100.9,4,1,1,6,Potential Loyalists
1691,14947.0,71,14,290.82,1,2,1,4,Lost Customers
1692,14948.0,22,64,1066.57,3,1,1,5,At Risk
1693,14950.0,8,20,361.25,4,1,1,6,Potential Loyalists
1694,14951.0,78,20,311.69,1,3,1,5,At Risk
1695,14952.0,45,149,7912.79,2,2,1,5,At Risk
1696,14953.0,24,55,289.82,3,1,1,5,At Risk
1697,14954.0,11,85,336.17,4,1,1,6,Potential Loyalists
1698,14957.0,252,12,58.49,1,5,2,8,Loyal Customers
1699,14958.0,146,42,499.68,1,4,2,7,Potential Loyalists
1700,14959.0,58,61,684.97,1,2,1,4,Lost Customers
1701,14960.0,7,27,221.27,5,1,1,7,Potential Loyalists
1702,14961.0,10,317,7006.58,4,1,1,6,Potential Loyalists
1703,14962.0,270,5,126.7,1,5,2,8,Loyal Customers
1704,14963.0,9,198,1487.8,4,1,1,6,Potential Loyalists
1705,14964.0,246,13,206.21,1,5,2,8,Loyal Customers
1706,14965.0,95,83,599.0,1,3,1,5,At Risk
1707,14966.0,14,38,191.32,4,1,1,6,Potential Loyalists
1708,14967.0,49,6,463.8,1,2,1,4,Lost Customers
1709,14968.0,29,37,147.59,3,1,1,5,At Risk
1710,14970.0,67,34,1592.06,1,2,1,4,Lost Customers
1711,14971.0,34,160,1116.57,2,1,1,4,Lost Customers
1712,14972.0,127,18,114.77,1,4,2,7,Potential Loyalists
1713,14973.0,106,32,1314.45,1,4,2,7,Potential Loyalists
1714,14974.0,36,21,114.39,2,1,1,4,Lost Customers
1715,14975.0,56,11,279.94,1,2,1,4,Lost Customers
1716,14976.0,56,71,749.86,1,2,1,4,Lost Customers
1717,14978.0,71,216,1931.42,1,2,1,4,Lost Customers
1718,14981.0,245,8,102.12,1,5,2,8,Loyal Customers
1719,14984.0,18,41,213.27,3,1,1,5,At Risk
1720,14985.0,197,87,296.75,1,5,2,8,Loyal Customers
1721,14987.0,15,4,326.4,3,1,1,5,At Risk
1722,14988.0,211,40,334.54,1,5,2,8,Loyal Customers
1723,14995.0,38,61,233.23000000000002,2,1,1,4,Lost Customers
1724,14997.0,45,27,540.98,2,2,1,5,At Risk
1725,14998.0,169,75,429.87,1,5,2,8,Loyal Customers
1726,15000.0,47,77,490.52,2,2,1,5,At Risk
1727,15002.0,115,115,1641.76,1,4,2,7,Potential Loyalists
1728,15004.0,146,157,1245.93,1,4,2,7,Potential Loyalists
1729,15005.0,15,1159,6178.79,3,1,1,5,At Risk
1730,15006.0,50,143,497.14,1,2,1,4,Lost Customers
1731,15007.0,158,12,156.91,1,5,2,8,Loyal Customers
1732,15009.0,11,182,1261.78,4,1,1,6,Potential Loyalists
1733,15010.0,35,20,308.94,2,1,1,4,Lost Customers
1734,15012.0,53,128,423.04,1,2,1,4,Lost Customers
1735,15014.0,42,35,260.17,2,2,1,5,At Risk
1736,15016.0,172,20,170.04,1,5,2,8,Loyal Customers
1737,15017.0,33,20,125.58,2,1,1,4,Lost Customers
1738,15018.0,38,32,456.26,2,1,1,4,Lost Customers
1739,15019.0,266,70,266.0,1,5,2,8,Loyal Customers
1740,15021.0,8,479,1872.28,4,1,1,6,Potential Loyalists
1741,15022.0,11,135,905.04,4,1,1,6,Potential Loyalists
1742,15023.0,2,561,6744.26,5,1,1,7,Potential Loyalists
1743,15024.0,9,155,1661.33,4,1,1,6,Potential Loyalists
1744,15025.0,32,72,377.01,2,1,1,4,Lost Customers
1745,15026.0,79,60,464.2,1,3,1,5,At Risk
1746,15027.0,30,37,1051.95,3,1,1,5,At Risk
1747,15028.0,7,48,627.13,5,1,1,7,Potential Loyalists
1748,15030.0,71,7,518.28,1,2,1,4,Lost Customers
1749,15031.0,3,111,668.14,5,1,1,7,Potential Loyalists
1750,15032.0,255,55,4464.1,1,5,2,8,Loyal Customers
1751,15033.0,4,512,2567.72,5,1,1,7,Potential Loyalists
1752,15034.0,15,400,4277.66,3,1,1,5,At Risk
1753,15035.0,89,27,252.73000000000002,1,3,1,5,At Risk
1754,15036.0,71,127,465.55,1,2,1,4,Lost Customers
1755,15038.0,42,133,665.59,2,2,1,5,At Risk
1756,15039.0,9,1508,19786.44,4,1,1,6,Potential Loyalists
1757,15041.0,169,67,180.35,1,5,2,8,Loyal Customers
1758,15042.0,198,5,135.93,1,5,2,8,Loyal Customers
1759,15043.0,30,3,537.0,3,1,1,5,At Risk
1760,15044.0,18,461,7629.38,3,1,1,5,At Risk
1761,15045.0,151,13,633.66,1,5,2,8,Loyal Customers
1762,15046.0,8,206,5045.0599999999995,4,1,1,6,Potential Loyalists
1763,15047.0,269,22,343.62,1,5,2,8,Loyal Customers
1764,15048.0,64,98,380.57,1,2,1,4,Lost Customers
1765,15049.0,273,3,121.17000000000002,1,5,2,8,Loyal Customers
1766,15050.0,24,80,1727.17,3,1,1,5,At Risk
1767,15051.0,22,143,1391.61,3,1,1,5,At Risk
1768,15052.0,318,30,215.78,1,5,3,9,Best Customers
1769,15053.0,4,71,697.79,5,1,1,7,Potential Loyalists
1770,15054.0,11,114,302.1,4,1,1,6,Potential Loyalists
1771,15057.0,274,25,1489.5,1,5,2,8,Loyal Customers
1772,15058.0,24,276,2124.99,3,1,1,5,At Risk
1773,15059.0,40,239,1325.82,2,1,1,4,Lost Customers
1774,15060.0,7,120,301.84000000000003,5,1,1,7,Potential Loyalists
1775,15061.0,3,409,54250.34,5,1,1,7,Potential Loyalists
1776,15062.0,70,57,987.86,1,2,1,4,Lost Customers
1777,15063.0,212,5,370.79999999999995,1,5,2,8,Loyal Customers
1778,15065.0,37,158,3135.98,2,1,1,4,Lost Customers
1779,15066.0,31,53,760.59,2,1,1,4,Lost Customers
1780,15067.0,77,82,1744.76,1,3,1,5,At Risk
1781,15068.0,45,104,553.36,2,2,1,5,At Risk
1782,15069.0,178,70,1109.53,1,5,2,8,Loyal Customers
1783,15070.0,372,1,106.2,1,5,3,9,Best Customers
1784,15071.0,93,26,982.07,1,3,1,5,At Risk
1785,15073.0,9,76,612.43,4,1,1,6,Potential Loyalists
1786,15074.0,104,42,748.87,1,4,2,7,Potential Loyalists
1787,15075.0,77,27,773.03,1,3,1,5,At Risk
1788,15076.0,172,49,880.85,1,5,2,8,Loyal Customers
1789,15078.0,6,451,9623.35,5,1,1,7,Potential Loyalists
1790,15079.0,212,48,893.66,1,5,2,8,Loyal Customers
1791,15081.0,21,35,487.35,3,1,1,5,At Risk
1792,15083.0,256,5,88.2,1,5,2,8,Loyal Customers
1793,15087.0,281,15,306.94,1,5,2,8,Loyal Customers
1794,15088.0,20,60,1140.27,3,1,1,5,At Risk
1795,15089.0,9,145,2420.84,4,1,1,6,Potential Loyalists
1796,15090.0,307,23,381.32,1,5,3,9,Best Customers
1797,15091.0,53,31,476.96,1,2,1,4,Lost Customers
1798,15092.0,214,26,457.81,1,5,2,8,Loyal Customers
1799,15093.0,17,112,4410.14,3,1,1,5,At Risk
1800,15095.0,103,49,1364.7,1,4,2,7,Potential Loyalists
1801,15096.0,42,11,219.39000000000001,2,2,1,5,At Risk
1802,15097.0,3,25,248.08,5,1,1,7,Potential Loyalists
1803,15098.0,181,4,39619.5,1,5,2,8,Loyal Customers
1804,15099.0,83,23,410.48,1,3,1,5,At Risk
1805,15100.0,329,6,635.1,1,5,3,9,Best Customers
1806,15101.0,8,9,310.03000000000003,4,1,1,6,Potential Loyalists
1807,15103.0,30,35,703.36,3,1,1,5,At Risk
1808,15104.0,166,71,1002.54,1,5,2,8,Loyal Customers
1809,15105.0,17,101,2298.93,3,1,1,5,At Risk
1810,15106.0,17,102,1407.73,3,1,1,5,At Risk
1811,15107.0,310,19,260.0,1,5,3,9,Best Customers
1812,15109.0,240,31,463.75,1,5,2,8,Loyal Customers
1813,15110.0,23,40,970.25,3,1,1,5,At Risk
1814,15111.0,28,84,1567.48,3,1,1,5,At Risk
1815,15113.0,9,100,3439.02,4,1,1,6,Potential Loyalists
1816,15114.0,29,197,2760.56,3,1,1,5,At Risk
1817,15115.0,17,21,340.11,3,1,1,5,At Risk
1818,15116.0,17,45,1352.75,3,1,1,5,At Risk
1819,15117.0,14,80,1550.13,4,1,1,6,Potential Loyalists
1820,15118.0,133,1,244.8,1,4,2,7,Potential Loyalists
1821,15119.0,245,14,266.4,1,5,2,8,Loyal Customers
1822,15120.0,129,22,343.82,1,4,2,7,Potential Loyalists
1823,15121.0,49,28,457.71999999999997,1,2,1,4,Lost Customers
1824,15122.0,84,87,1612.13,1,3,1,5,At Risk
1825,15123.0,6,106,2199.31,5,1,1,7,Potential Loyalists
1826,15124.0,22,15,184.19,3,1,1,5,At Risk
1827,15125.0,24,140,11117.05,3,1,1,5,At Risk
1828,15127.0,65,16,406.53,1,2,1,4,Lost Customers
1829,15128.0,59,110,1423.25,1,2,1,4,Lost Customers
1830,15129.0,49,84,3447.4,1,2,1,4,Lost Customers
1831,15130.0,169,22,330.11,1,5,2,8,Loyal Customers
1832,15132.0,17,52,977.9300000000001,3,1,1,5,At Risk
1833,15133.0,127,29,982.42,1,4,2,7,Potential Loyalists
1834,15134.0,14,73,1387.99,4,1,1,6,Potential Loyalists
1835,15135.0,232,10,127.15,1,5,2,8,Loyal Customers
1836,15136.0,2,69,1282.45,5,1,1,7,Potential Loyalists
1837,15139.0,239,13,178.96,1,5,2,8,Loyal Customers
1838,15140.0,51,81,2350.0,1,2,1,4,Lost Customers
1839,15142.0,45,26,498.74,2,2,1,5,At Risk
1840,15143.0,225,14,259.45,1,5,2,8,Loyal Customers
1841,15144.0,7,218,6530.04,5,1,1,7,Potential Loyalists
1842,15145.0,3,67,1194.73,5,1,1,7,Potential Loyalists
1843,15146.0,164,95,1313.66,1,5,2,8,Loyal Customers
1844,15147.0,218,29,608.65,1,5,2,8,Loyal Customers
1845,15148.0,10,20,301.29,4,1,1,6,Potential Loyalists
1846,15149.0,133,23,520.8000000000001,1,4,2,7,Potential Loyalists
1847,15150.0,16,344,5303.97,3,1,1,5,At Risk
1848,15152.0,9,278,4684.24,4,1,1,6,Potential Loyalists
1849,15153.0,30,22,329.25,3,1,1,5,At Risk
1850,15154.0,73,92,240.27,1,2,1,4,Lost Customers
1851,15156.0,0,55,961.49,5,1,1,7,Potential Loyalists
1852,15157.0,3,132,1879.84,5,1,1,7,Potential Loyalists
1853,15158.0,44,7,401.40000000000003,2,2,1,5,At Risk
1854,15159.0,1,720,18573.68,5,1,1,7,Potential Loyalists
1855,15160.0,356,4,158.16,1,5,3,9,Best Customers
1856,15163.0,17,29,304.47,3,1,1,5,At Risk
1857,15164.0,68,103,843.05,1,2,1,4,Lost Customers
1858,15165.0,372,27,487.75,1,5,3,9,Best Customers
1859,15167.0,320,41,163.0,1,5,3,9,Best Customers
1860,15168.0,25,5,106.56,3,1,1,5,At Risk
1861,15171.0,324,7,1034.5,1,5,3,9,Best Customers
1862,15172.0,8,110,1624.05,4,1,1,6,Potential Loyalists
1863,15174.0,322,11,135.75,1,5,3,9,Best Customers
1864,15175.0,71,23,224.14,1,2,1,4,Lost Customers
1865,15178.0,259,3,40.5,1,5,2,8,Loyal Customers
1866,15179.0,17,95,2186.2,3,1,1,5,At Risk
1867,15180.0,366,6,87.5,1,5,3,9,Best Customers
1868,15181.0,65,17,684.53,1,2,1,4,Lost Customers
1869,15182.0,153,29,622.85,1,5,2,8,Loyal Customers
1870,15184.0,28,63,406.76,3,1,1,5,At Risk
1871,15185.0,69,21,310.62,1,2,1,4,Lost Customers
1872,15186.0,13,19,411.41,4,1,1,6,Potential Loyalists
1873,15187.0,1,92,4655.08,5,1,1,7,Potential Loyalists
1874,15189.0,0,232,15802.14,5,1,1,7,Potential Loyalists
1875,15192.0,119,51,1044.32,1,4,2,7,Potential Loyalists
1876,15193.0,60,19,499.32,1,2,1,4,Lost Customers
1877,15194.0,2,326,7521.17,5,1,1,7,Potential Loyalists
1878,15195.0,2,1,3861.0,5,1,1,7,Potential Loyalists
1879,15197.0,8,36,656.44,4,1,1,6,Potential Loyalists
1880,15198.0,91,10,193.64,1,3,1,5,At Risk
1881,15199.0,58,13,1268.7,1,2,1,4,Lost Customers
1882,15201.0,78,97,927.84,1,3,1,5,At Risk
1883,15203.0,25,142,1827.8,3,1,1,5,At Risk
1884,15204.0,356,9,316.58,1,5,3,9,Best Customers
1885,15205.0,84,37,653.24,1,3,1,5,At Risk
1886,15206.0,9,9,420.3,4,1,1,6,Potential Loyalists
1887,15208.0,0,43,867.62,5,1,1,7,Potential Loyalists
1888,15210.0,224,20,331.18,1,5,2,8,Loyal Customers
1889,15211.0,59,52,894.4100000000001,1,2,1,4,Lost Customers
1890,15212.0,238,7,88.95,1,5,2,8,Loyal Customers
1891,15213.0,318,25,325.05,1,5,3,9,Best Customers
1892,15214.0,1,110,1661.44,5,1,1,7,Potential Loyalists
1893,15215.0,44,43,615.99,2,2,1,5,At Risk
1894,15216.0,87,2,96.6,1,3,1,5,At Risk
1895,15218.0,10,166,5756.89,4,1,1,6,Potential Loyalists
1896,15219.0,175,9,305.75,1,5,2,8,Loyal Customers
1897,15220.0,51,119,1758.92,1,2,1,4,Lost Customers
1898,15221.0,365,11,114.1,1,5,3,9,Best Customers
1899,15222.0,318,5,585.0,1,5,3,9,Best Customers
1900,15223.0,225,32,454.90000000000003,1,5,2,8,Loyal Customers
1901,15224.0,357,16,310.48,1,5,3,9,Best Customers
1902,15225.0,233,23,409.40000000000003,1,5,2,8,Loyal Customers
1903,15226.0,310,8,154.41,1,5,3,9,Best Customers
1904,15227.0,36,58,1219.4,2,1,1,4,Lost Customers
1905,15228.0,65,126,3376.96,1,2,1,4,Lost Customers
1906,15230.0,238,23,429.6,1,5,2,8,Loyal Customers
1907,15232.0,112,31,612.06,1,4,2,7,Potential Loyalists
1908,15234.0,276,14,197.0,1,5,2,8,Loyal Customers
1909,15235.0,217,143,2247.51,1,5,2,8,Loyal Customers
1910,15236.0,298,15,321.05,1,5,2,8,Loyal Customers
1911,15237.0,1,99,1412.32,5,1,1,7,Potential Loyalists
1912,15238.0,28,52,1056.54,3,1,1,5,At Risk
1913,15239.0,9,52,764.34,4,1,1,6,Potential Loyalists
1914,15240.0,44,83,1685.57,2,2,1,5,At Risk
1915,15241.0,66,111,1738.59,1,2,1,4,Lost Customers
1916,15243.0,73,22,316.68,1,2,1,4,Lost Customers
1917,15244.0,64,34,631.57,1,2,1,4,Lost Customers
1918,15245.0,133,89,2515.84,1,4,2,7,Potential Loyalists
1919,15246.0,237,33,514.15,1,5,2,8,Loyal Customers
1920,15247.0,121,6,356.0,1,4,2,7,Potential Loyalists
1921,15249.0,31,358,6657.36,2,1,1,4,Lost Customers
1922,15251.0,8,121,10327.11,4,1,1,6,Potential Loyalists
1923,15252.0,35,44,740.78,2,1,1,4,Lost Customers
1924,15253.0,15,55,915.3,3,1,1,5,At Risk
1925,15254.0,126,18,300.36,1,4,2,7,Potential Loyalists
1926,15255.0,66,47,890.85,1,2,1,4,Lost Customers
1927,15256.0,148,6,98.45,1,4,2,7,Potential Loyalists
1928,15257.0,280,8,232.14999999999998,1,5,2,8,Loyal Customers
1929,15258.0,168,34,623.16,1,5,2,8,Loyal Customers
1930,15260.0,99,78,1780.77,1,3,1,5,At Risk
1931,15261.0,134,19,254.82,1,4,2,7,Potential Loyalists
1932,15262.0,323,10,178.95000000000002,1,5,3,9,Best Customers
1933,15263.0,106,12,156.51,1,4,2,7,Potential Loyalists
1934,15264.0,63,23,393.74,1,2,1,4,Lost Customers
1935,15265.0,150,82,1506.12,1,5,2,8,Loyal Customers
1936,15266.0,337,6,119.3,1,5,3,9,Best Customers
1937,15267.0,21,11,1717.36,3,1,1,5,At Risk
1938,15269.0,23,2,408.8,3,1,1,5,At Risk
1939,15270.0,15,48,2298.2,3,1,1,5,At Risk
1940,15271.0,6,275,2485.82,5,1,1,7,Potential Loyalists
1941,15272.0,56,63,721.94,1,2,1,4,Lost Customers
1942,15274.0,3,47,716.57,5,1,1,7,Potential Loyalists
1943,15275.0,30,42,609.1899999999999,3,1,1,5,At Risk
1944,15276.0,65,52,135.31,1,2,1,4,Lost Customers
1945,15277.0,46,12,255.89999999999998,2,2,1,5,At Risk
1946,15279.0,354,21,277.41,1,5,3,9,Best Customers
1947,15280.0,171,16,113.12,1,5,2,8,Loyal Customers
1948,15281.0,58,150,2239.95,1,2,1,4,Lost Customers
1949,15286.0,49,3,240.55,1,2,1,4,Lost Customers
1950,15287.0,21,21,485.24,3,1,1,5,At Risk
1951,15288.0,42,88,2306.52,2,2,1,5,At Risk
1952,15289.0,28,59,935.1,3,1,1,5,At Risk
1953,15290.0,4,212,7803.7699999999995,5,1,1,7,Potential Loyalists
1954,15291.0,25,108,4551.51,3,1,1,5,At Risk
1955,15292.0,200,25,180.94,1,5,2,8,Loyal Customers
1956,15296.0,43,200,3610.31,2,2,1,5,At Risk
1957,15297.0,9,41,635.04,4,1,1,6,Potential Loyalists
1958,15298.0,1,194,3774.1,5,1,1,7,Potential Loyalists
1959,15299.0,66,8,3901.0,1,2,1,4,Lost Customers
1960,15300.0,63,28,496.44,1,2,1,4,Lost Customers
1961,15301.0,50,247,5028.12,1,2,1,4,Lost Customers
1962,15303.0,289,31,574.02,1,5,2,8,Loyal Customers
1963,15304.0,60,26,680.3,1,2,1,4,Lost Customers
1964,15306.0,63,58,1174.35,1,2,1,4,Lost Customers
1965,15307.0,95,12,205.3,1,3,1,5,At Risk
1966,15308.0,270,21,302.27,1,5,2,8,Loyal Customers
1967,15311.0,0,2491,59419.340000000004,5,1,1,7,Potential Loyalists
1968,15312.0,74,48,921.1,1,2,1,4,Lost Customers
1969,15313.0,109,1,52.0,1,4,2,7,Potential Loyalists
1970,15314.0,198,24,327.96999999999997,1,5,2,8,Loyal Customers
1971,15315.0,63,38,551.54,1,2,1,4,Lost Customers
1972,15316.0,326,1,165.0,1,5,3,9,Best Customers
1973,15318.0,3,33,312.62,5,1,1,7,Potential Loyalists
1974,15319.0,283,16,204.5,1,5,2,8,Loyal Customers
1975,15320.0,43,36,267.13,2,2,1,5,At Risk
1976,15321.0,48,106,2650.73,1,2,1,4,Lost Customers
1977,15322.0,63,49,602.97,1,2,1,4,Lost Customers
1978,15325.0,103,49,162.29,1,4,2,7,Potential Loyalists
1979,15326.0,333,29,311.71,1,5,3,9,Best Customers
1980,15327.0,52,10,208.75,1,2,1,4,Lost Customers
1981,15329.0,34,61,1007.5,2,1,1,4,Lost Customers
1982,15330.0,31,13,714.9599999999999,2,1,1,4,Lost Customers
1983,15333.0,207,16,1028.56,1,5,2,8,Loyal Customers
1984,15334.0,156,98,348.72,1,5,2,8,Loyal Customers
1985,15335.0,53,36,173.97,1,2,1,4,Lost Customers
1986,15339.0,65,88,557.57,1,2,1,4,Lost Customers
1987,15341.0,80,17,2020.52,1,3,1,5,At Risk
1988,15342.0,115,26,391.76,1,4,2,7,Potential Loyalists
1989,15343.0,86,21,364.5,1,3,1,5,At Risk
1990,15344.0,0,32,476.58,5,1,1,7,Potential Loyalists
1991,15345.0,34,23,367.69,2,1,1,4,Lost Customers
1992,15346.0,332,17,252.42000000000002,1,5,3,9,Best Customers
1993,15347.0,365,5,201.60000000000002,1,5,3,9,Best Customers
1994,15348.0,71,9,158.04,1,2,1,4,Lost Customers
1995,15349.0,157,72,473.81,1,5,2,8,Loyal Customers
1996,15350.0,372,5,115.65,1,5,3,9,Best Customers
1997,15351.0,11,233,1862.14,4,1,1,6,Potential Loyalists
1998,15353.0,254,63,777.02,1,5,2,8,Loyal Customers
1999,15355.0,28,14,277.05,3,1,1,5,At Risk
2000,15356.0,30,519,2766.5,3,1,1,5,At Risk
2001,15358.0,4,561,8234.8,5,1,1,7,Potential Loyalists
2002,15360.0,39,13,427.93,2,1,1,4,Lost Customers
2003,15361.0,361,7,418.92,1,5,3,9,Best Customers
2004,15363.0,240,17,318.05,1,5,2,8,Loyal Customers
2005,15364.0,95,29,913.19,1,3,1,5,At Risk
2006,15365.0,25,150,1549.17,3,1,1,5,At Risk
2007,15366.0,74,44,602.51,1,2,1,4,Lost Customers
2008,15367.0,56,96,1867.69,1,2,1,4,Lost Customers
2009,15368.0,20,4,446.94000000000005,3,1,1,5,At Risk
2010,15370.0,40,95,2360.55,2,1,1,4,Lost Customers
2011,15372.0,136,27,2007.4,1,4,2,7,Potential Loyalists
2012,15373.0,7,137,2213.11,5,1,1,7,Potential Loyalists
2013,15374.0,128,3,168.0,1,4,2,7,Potential Loyalists
2014,15376.0,39,117,1233.3600000000001,2,1,1,4,Lost Customers
2015,15379.0,168,196,3631.89,1,5,2,8,Loyal Customers
2016,15380.0,8,37,1682.36,4,1,1,6,Potential Loyalists
2017,15381.0,213,8,596.85,1,5,2,8,Loyal Customers
2018,15382.0,14,306,5927.86,4,1,1,6,Potential Loyalists
2019,15384.0,169,43,635.76,1,5,2,8,Loyal Customers
2020,15385.0,39,12,316.88,2,1,1,4,Lost Customers
2021,15386.0,185,31,394.14,1,5,2,8,Loyal Customers
2022,15389.0,171,1,500.0,1,5,2,8,Loyal Customers
2023,15392.0,4,85,1515.73,5,1,1,7,Potential Loyalists
2024,15393.0,15,12,231.86,3,1,1,5,At Risk
2025,15394.0,9,85,2183.54,4,1,1,6,Potential Loyalists
2026,15395.0,325,7,107.45,1,5,3,9,Best Customers
2027,15396.0,112,14,288.18,1,4,2,7,Potential Loyalists
2028,15397.0,289,6,94.0,1,5,2,8,Loyal Customers
2029,15398.0,15,74,1339.63,3,1,1,5,At Risk
2030,15399.0,0,50,815.77,5,1,1,7,Potential Loyalists
2031,15400.0,91,13,666.7,1,3,1,5,At Risk
2032,15402.0,148,41,626.35,1,4,2,7,Potential Loyalists
2033,15405.0,188,8,349.1,1,5,2,8,Loyal Customers
2034,15406.0,17,58,426.61,3,1,1,5,At Risk
2035,15407.0,33,153,1056.44,2,1,1,4,Lost Customers
2036,15408.0,263,34,267.18,1,5,2,8,Loyal Customers
2037,15410.0,83,122,3450.84,1,3,1,5,At Risk
2038,15411.0,25,100,1346.38,3,1,1,5,At Risk
2039,15412.0,170,10,190.53,1,5,2,8,Loyal Customers
2040,15414.0,9,39,774.9,4,1,1,6,Potential Loyalists
2041,15415.0,312,48,572.8100000000001,1,5,3,9,Best Customers
2042,15416.0,64,193,3974.37,1,2,1,4,Lost Customers
2043,15417.0,84,28,508.8,1,3,1,5,At Risk
2044,15419.0,24,8,135.86,3,1,1,5,At Risk
2045,15421.0,58,53,950.36,1,2,1,4,Lost Customers
2046,15422.0,322,6,97.7,1,5,3,9,Best Customers
2047,15423.0,37,2,43.5,2,1,1,4,Lost Customers
2048,15424.0,253,17,383.34,1,5,2,8,Loyal Customers
2049,15426.0,18,300,1429.9,3,1,1,5,At Risk
2050,15427.0,32,306,1483.14,2,1,1,4,Lost Customers
2051,15428.0,14,6,93.78,4,1,1,6,Potential Loyalists
2052,15429.0,26,83,364.9,3,1,1,5,At Risk
2053,15432.0,22,10,171.19000000000003,3,1,1,5,At Risk
2054,15433.0,78,53,417.87,1,3,1,5,At Risk
2055,15434.0,7,59,997.48,5,1,1,7,Potential Loyalists
2056,15435.0,21,29,149.29,3,1,1,5,At Risk
2057,15436.0,11,329,1122.53,4,1,1,6,Potential Loyalists
2058,15437.0,261,45,200.16,1,5,2,8,Loyal Customers
2059,15438.0,130,25,156.57999999999998,1,4,2,7,Potential Loyalists
2060,15440.0,54,62,383.68,1,2,1,4,Lost Customers
2061,15442.0,248,2,594.0,1,5,2,8,Loyal Customers
2062,15443.0,1,385,3212.16,5,1,1,7,Potential Loyalists
2063,15444.0,8,219,1418.26,4,1,1,6,Potential Loyalists
2064,15445.0,263,5,113.5,1,5,2,8,Loyal Customers
2065,15447.0,330,9,155.17,1,5,3,9,Best Customers
2066,15448.0,312,28,494.64,1,5,3,9,Best Customers
2067,15449.0,25,62,971.22,3,1,1,5,At Risk
2068,15450.0,29,30,429.84,3,1,1,5,At Risk
2069,15452.0,29,58,538.73,3,1,1,5,At Risk
2070,15453.0,1,286,1388.37,5,1,1,7,Potential Loyalists
2071,15454.0,361,25,179.1,1,5,3,9,Best Customers
2072,15456.0,282,60,447.22,1,5,2,8,Loyal Customers
2073,15457.0,261,58,237.07,1,5,2,8,Loyal Customers
2074,15458.0,24,7,161.64,3,1,1,5,At Risk
2075,15460.0,353,58,216.76,1,5,3,9,Best Customers
2076,15462.0,93,11,234.6,1,3,1,5,At Risk
2077,15463.0,28,7,126.14,3,1,1,5,At Risk
2078,15464.0,337,157,1048.85,1,5,3,9,Best Customers
2079,15465.0,19,104,6945.0199999999995,3,1,1,5,At Risk
2080,15466.0,84,57,334.53,1,3,1,5,At Risk
2081,15467.0,8,53,511.88,4,1,1,6,Potential Loyalists
2082,15468.0,34,29,438.46,2,1,1,4,Lost Customers
2083,15469.0,42,27,504.5,2,2,1,5,At Risk
2084,15471.0,1,77,469.48,5,1,1,7,Potential Loyalists
2085,15472.0,112,76,371.56,1,4,2,7,Potential Loyalists
2086,15473.0,13,14,1465.2,4,1,1,6,Potential Loyalists
2087,15475.0,76,29,454.11,1,3,1,5,At Risk
2088,15478.0,39,46,1441.42,2,1,1,4,Lost Customers
2089,15482.0,15,126,6528.72,3,1,1,5,At Risk
2090,15483.0,160,88,233.81,1,5,2,8,Loyal Customers
2091,15484.0,0,189,3563.11,5,1,1,7,Potential Loyalists
2092,15485.0,29,86,2575.0,3,1,1,5,At Risk
2093,15488.0,92,2,91.32000000000001,1,3,1,5,At Risk
2094,15489.0,22,55,1090.03,3,1,1,5,At Risk
2095,15491.0,94,155,3090.85,1,3,1,5,At Risk
2096,15492.0,27,35,659.4599999999999,3,1,1,5,At Risk
2097,15493.0,32,299,1967.25,2,1,1,4,Lost Customers
2098,15494.0,20,125,1299.23,3,1,1,5,At Risk
2099,15497.0,17,16,1259.7,3,1,1,5,At Risk
2100,15498.0,2,517,13252.55,5,1,1,7,Potential Loyalists
2101,15500.0,7,68,1131.56,5,1,1,7,Potential Loyalists
2102,15502.0,15,243,5548.58,3,1,1,5,At Risk
2103,15503.0,362,70,147.09,1,5,3,9,Best Customers
2104,15504.0,80,13,52.83,1,3,1,5,At Risk
2105,15505.0,52,99,3497.14,1,2,1,4,Lost Customers
2106,15506.0,22,164,979.26,3,1,1,5,At Risk
2107,15507.0,171,46,492.36,1,5,2,8,Loyal Customers
2108,15508.0,188,92,1000.27,1,5,2,8,Loyal Customers
2109,15510.0,330,1,250.0,1,5,3,9,Best Customers
2110,15511.0,11,160,909.23,4,1,1,6,Potential Loyalists
2111,15512.0,155,7,121.0,1,5,2,8,Loyal Customers
2112,15513.0,30,314,14520.08,3,1,1,5,At Risk
2113,15514.0,11,218,2963.19,4,1,1,6,Potential Loyalists
2114,15516.0,44,15,62.43,2,2,1,5,At Risk
2115,15517.0,232,27,267.03,1,5,2,8,Loyal Customers
2116,15518.0,63,219,1918.65,1,2,1,4,Lost Customers
2117,15520.0,1,18,343.5,5,1,1,7,Potential Loyalists
2118,15521.0,35,199,2699.65,2,1,1,4,Lost Customers
2119,15522.0,32,57,398.84,2,1,1,4,Lost Customers
2120,15523.0,83,10,412.01000000000005,1,3,1,5,At Risk
2121,15524.0,24,1,440.0,3,1,1,5,At Risk
2122,15525.0,1,179,808.52,5,1,1,7,Potential Loyalists
2123,15526.0,32,4,148.44,2,1,1,4,Lost Customers
2124,15527.0,18,165,2412.93,3,1,1,5,At Risk
2125,15528.0,253,26,229.33,1,5,2,8,Loyal Customers
2126,15529.0,22,673,3965.23,3,1,1,5,At Risk
2127,15530.0,21,108,1502.3500000000001,3,1,1,5,At Risk
2128,15531.0,7,228,2007.44,5,1,1,7,Potential Loyalists
2129,15532.0,24,262,1507.18,3,1,1,5,At Risk
2130,15533.0,18,86,746.92,3,1,1,5,At Risk
2131,15535.0,172,78,459.9,1,5,2,8,Loyal Customers
2132,15537.0,162,24,110.92,1,5,2,8,Loyal Customers
2133,15539.0,6,41,538.46,5,1,1,7,Potential Loyalists
2134,15540.0,10,15,213.3,4,1,1,6,Potential Loyalists
2135,15541.0,113,29,85.13000000000001,1,4,2,7,Potential Loyalists
2136,15543.0,287,28,127.86,1,5,2,8,Loyal Customers
2137,15544.0,8,261,3542.5099999999998,4,1,1,6,Potential Loyalists
2138,15545.0,53,81,292.71999999999997,1,2,1,4,Lost Customers
2139,15547.0,6,702,4954.84,5,1,1,7,Potential Loyalists
2140,15549.0,76,115,1652.01,1,3,1,5,At Risk
2141,15550.0,3,61,575.63,5,1,1,7,Potential Loyalists
2142,15551.0,36,29,436.06,2,1,1,4,Lost Customers
2143,15552.0,216,17,90.12,1,5,2,8,Loyal Customers
2144,15553.0,59,56,437.23,1,2,1,4,Lost Customers
2145,15554.0,277,14,217.2,1,5,2,8,Loyal Customers
2146,15555.0,11,922,4756.06,4,1,1,6,Potential Loyalists
2147,15556.0,23,31,279.77,3,1,1,5,At Risk
2148,15557.0,28,20,473.65000000000003,3,1,1,5,At Risk
2149,15561.0,11,31,722.74,4,1,1,6,Potential Loyalists
2150,15562.0,351,1,134.55,1,5,3,9,Best Customers
2151,15563.0,8,114,1310.69,4,1,1,6,Potential Loyalists
2152,15565.0,49,8,173.16000000000003,1,2,1,4,Lost Customers
2153,15567.0,18,7,186.01,3,1,1,5,At Risk
2154,15568.0,2,53,758.29,5,1,1,7,Potential Loyalists
2155,15569.0,103,31,1375.71,1,4,2,7,Potential Loyalists
2156,15570.0,6,330,4109.97,5,1,1,7,Potential Loyalists
2157,15571.0,11,57,650.4300000000001,4,1,1,6,Potential Loyalists
2158,15572.0,4,215,2552.86,5,1,1,7,Potential Loyalists
2159,15573.0,31,103,599.5,2,1,1,4,Lost Customers
2160,15574.0,177,168,702.25,1,5,2,8,Loyal Customers
2161,15576.0,37,45,940.67,2,1,1,4,Lost Customers
2162,15577.0,150,39,258.88,1,5,2,8,Loyal Customers
2163,15578.0,161,13,127.1,1,5,2,8,Loyal Customers
2164,15579.0,68,51,348.6,1,2,1,4,Lost Customers
2165,15581.0,155,146,721.63,1,5,2,8,Loyal Customers
2166,15582.0,24,44,682.9100000000001,3,1,1,5,At Risk
2167,15584.0,23,125,722.61,3,1,1,5,At Risk
2168,15585.0,176,31,455.3,1,5,2,8,Loyal Customers
2169,15587.0,49,9,913.68,1,2,1,4,Lost Customers
2170,15589.0,252,30,456.58,1,5,2,8,Loyal Customers
2171,15592.0,46,24,388.58,2,2,1,5,At Risk
2172,15593.0,70,5,199.8,1,2,1,4,Lost Customers
2173,15594.0,15,104,1767.53,3,1,1,5,At Risk
2174,15596.0,100,84,1343.34,1,3,2,6,Potential Loyalists
2175,15597.0,29,23,315.71999999999997,3,1,1,5,At Risk
2176,15598.0,34,16,235.68,2,1,1,4,Lost Customers
2177,15599.0,26,52,761.74,3,1,1,5,At Risk
2178,15601.0,10,414,6745.36,4,1,1,6,Potential Loyalists
2179,15602.0,7,52,1102.3700000000001,5,1,1,7,Potential Loyalists
2180,15603.0,78,2,48.480000000000004,1,3,1,5,At Risk
2181,15604.0,51,17,216.39,1,2,1,4,Lost Customers
2182,15605.0,35,67,1198.23,2,1,1,4,Lost Customers
2183,15606.0,56,91,2422.64,1,2,1,4,Lost Customers
2184,15607.0,336,13,104.76,1,5,3,9,Best Customers
2185,15608.0,27,60,1093.68,3,1,1,5,At Risk
2186,15609.0,182,18,270.03000000000003,1,5,2,8,Loyal Customers
2187,15610.0,51,6,112.46000000000001,1,2,1,4,Lost Customers
2188,15611.0,9,43,1547.39,4,1,1,6,Potential Loyalists
2189,15612.0,35,6,195.15,2,1,1,4,Lost Customers
2190,15615.0,9,429,10360.04,4,1,1,6,Potential Loyalists
2191,15618.0,32,48,747.03,2,1,1,4,Lost Customers
2192,15619.0,10,3,336.4,4,1,1,6,Potential Loyalists
2193,15620.0,49,104,1524.4,1,2,1,4,Lost Customers
2194,15621.0,3,18,1158.77,5,1,1,7,Potential Loyalists
2195,15622.0,2,214,3224.53,5,1,1,7,Potential Loyalists
2196,15623.0,140,19,301.03,1,4,2,7,Potential Loyalists
2197,15624.0,116,34,588.13,1,4,2,7,Potential Loyalists
2198,15625.0,99,68,1504.56,1,3,1,5,At Risk
2199,15626.0,74,49,675.8,1,2,1,4,Lost Customers
2200,15628.0,4,157,2865.64,5,1,1,7,Potential Loyalists
2201,15630.0,44,61,1180.4,2,2,1,5,At Risk
2202,15632.0,15,177,3147.31,3,1,1,5,At Risk
2203,15634.0,16,15,243.55,3,1,1,5,At Risk
2204,15636.0,89,25,724.76,1,3,1,5,At Risk
2205,15637.0,52,15,223.36,1,2,1,4,Lost Customers
2207,15639.0,133,25,425.32,1,4,2,7,Potential Loyalists
2208,15640.0,3,495,12433.34,5,1,1,7,Potential Loyalists
2209,15641.0,104,119,1887.2,1,4,2,7,Potential Loyalists
2210,15643.0,178,36,647.4,1,5,2,8,Loyal Customers
2211,15644.0,165,238,813.0,1,5,2,8,Loyal Customers
2212,15645.0,18,51,611.59,3,1,1,5,At Risk
2213,15646.0,157,36,425.14000000000004,1,5,2,8,Loyal Customers
2214,15648.0,203,27,602.6,1,5,2,8,Loyal Customers
2215,15649.0,335,2,816.0,1,5,3,9,Best Customers
2216,15651.0,36,32,646.3,2,1,1,4,Lost Customers
2217,15652.0,90,21,337.74,1,3,1,5,At Risk
2218,15653.0,92,6,877.44,1,3,1,5,At Risk
2219,15654.0,8,21,922.53,4,1,1,6,Potential Loyalists
2220,15655.0,232,37,511.32,1,5,2,8,Loyal Customers
2221,15656.0,44,47,748.5,2,2,1,5,At Risk
2222,15657.0,22,1,30.0,3,1,1,5,At Risk
2223,15658.0,189,56,958.9,1,5,2,8,Loyal Customers
2224,15659.0,43,11,306.45,2,2,1,5,At Risk
2225,15660.0,24,94,1552.01,3,1,1,5,At Risk
2226,15661.0,316,5,309.8,1,5,3,9,Best Customers
2227,15663.0,105,9,138.14,1,4,2,7,Potential Loyalists
2228,15664.0,50,19,358.63,1,2,1,4,Lost Customers
2229,15665.0,167,116,2242.01,1,5,2,8,Loyal Customers
2230,15667.0,39,13,301.32,2,1,1,4,Lost Customers
2231,15668.0,217,1,76.32000000000001,1,5,2,8,Loyal Customers
2232,15669.0,39,35,677.69,2,1,1,4,Lost Customers
2233,15670.0,296,12,173.05,1,5,2,8,Loyal Customers
2234,15671.0,18,81,2635.4900000000002,3,1,1,5,At Risk
2235,15673.0,87,155,2881.02,1,3,1,5,At Risk
2236,15674.0,72,133,1744.02,1,2,1,4,Lost Customers
2237,15675.0,80,21,323.69,1,3,1,5,At Risk
2238,15676.0,8,216,3324.09,4,1,1,6,Potential Loyalists
2239,15677.0,48,33,657.23,1,2,1,4,Lost Customers
2240,15678.0,52,12,352.7,1,2,1,4,Lost Customers
2241,15679.0,23,110,781.28,3,1,1,5,At Risk
2242,15680.0,8,78,1333.68,4,1,1,6,Potential Loyalists
2243,15681.0,17,67,946.36,3,1,1,5,At Risk
2244,15683.0,116,10,193.75,1,4,2,7,Potential Loyalists
2245,15687.0,8,168,2981.5,4,1,1,6,Potential Loyalists
2246,15689.0,119,9,254.1,1,4,2,7,Potential Loyalists
2247,15690.0,3,19,239.76,5,1,1,7,Potential Loyalists
2248,15691.0,251,2,136.8,1,5,2,8,Loyal Customers
2249,15692.0,27,12,191.04,3,1,1,5,At Risk
2250,15694.0,0,78,6408.6,5,1,1,7,Potential Loyalists
2251,15695.0,266,22,409.98,1,5,2,8,Loyal Customers
2252,15696.0,32,177,2644.46,2,1,1,4,Lost Customers
2253,15699.0,17,18,309.65,3,1,1,5,At Risk
2254,15700.0,171,89,664.03,1,5,2,8,Loyal Customers
2255,15701.0,1,237,1542.14,5,1,1,7,Potential Loyalists
2256,15703.0,264,5,211.5,1,5,2,8,Loyal Customers
2257,15704.0,139,117,2293.62,1,4,2,7,Potential Loyalists
2258,15705.0,200,6,143.1,1,5,2,8,Loyal Customers
2259,15706.0,59,59,1001.8100000000001,1,2,1,4,Lost Customers
2260,15707.0,34,214,945.58,2,1,1,4,Lost Customers
2261,15708.0,40,297,3329.7200000000003,2,1,1,4,Lost Customers
2262,15709.0,283,6,133.25,1,5,2,8,Loyal Customers
2263,15712.0,8,53,1072.36,4,1,1,6,Potential Loyalists
2264,15713.0,142,20,346.75,1,4,2,7,Potential Loyalists
2265,15714.0,11,35,330.88,4,1,1,6,Potential Loyalists
2266,15716.0,145,118,1118.81,1,4,2,7,Potential Loyalists
2267,15717.0,233,7,150.3,1,5,2,8,Loyal Customers
2268,15719.0,32,937,5042.31,2,1,1,4,Lost Customers
2269,15720.0,23,128,598.73,3,1,1,5,At Risk
2270,15721.0,11,91,507.08,4,1,1,6,Potential Loyalists
2271,15722.0,35,72,2181.21,2,1,1,4,Lost Customers
2272,15723.0,364,41,203.10000000000002,1,5,3,9,Best Customers
2273,15724.0,200,12,212.3,1,5,2,8,Loyal Customers
2274,15725.0,14,32,415.25,4,1,1,6,Potential Loyalists
2275,15727.0,16,302,5178.96,3,1,1,5,At Risk
2277,15729.0,197,6,62.0,1,5,2,8,Loyal Customers
2278,15730.0,65,73,1108.38,1,2,1,4,Lost Customers
2279,15732.0,211,14,294.12,1,5,2,8,Loyal Customers
2280,15733.0,282,10,162.3,1,5,2,8,Loyal Customers
2281,15734.0,114,26,1339.45,1,4,2,7,Potential Loyalists
2282,15737.0,14,81,1121.21,4,1,1,6,Potential Loyalists
2283,15738.0,18,176,4788.77,3,1,1,5,At Risk
2284,15739.0,65,8,449.12,1,2,1,4,Lost Customers
2285,15740.0,48,9,154.88,1,2,1,4,Lost Customers
2286,15743.0,15,88,784.46,3,1,1,5,At Risk
2287,15744.0,77,3,34.8,1,3,1,5,At Risk
2288,15745.0,8,65,1071.24,4,1,1,6,Potential Loyalists
2289,15746.0,133,29,182.96,1,4,2,7,Potential Loyalists
2290,15747.0,12,93,974.04,4,1,1,6,Potential Loyalists
2291,15748.0,39,21,149.31,2,1,1,4,Lost Customers
2292,15749.0,234,15,21535.9,1,5,2,8,Loyal Customers
2293,15750.0,2,295,2451.23,5,1,1,7,Potential Loyalists
2294,15752.0,39,412,2628.93,2,1,1,4,Lost Customers
2295,15753.0,304,1,79.2,1,5,3,9,Best Customers
2296,15754.0,50,29,455.67,1,2,1,4,Lost Customers
2297,15755.0,0,149,2318.88,5,1,1,7,Potential Loyalists
2298,15756.0,60,192,532.96,1,2,1,4,Lost Customers
2299,15757.0,65,45,714.42,1,2,1,4,Lost Customers
2300,15758.0,24,9,205.25,3,1,1,5,At Risk
2301,15759.0,217,7,253.04,1,5,2,8,Loyal Customers
2302,15762.0,64,37,583.75,1,2,1,4,Lost Customers
2303,15763.0,31,63,1048.67,2,1,1,4,Lost Customers
2304,15764.0,80,188,3245.47,1,3,1,5,At Risk
2305,15766.0,63,11,315.06,1,2,1,4,Lost Customers
2306,15768.0,115,27,621.8299999999999,1,4,2,7,Potential Loyalists
2307,15769.0,6,147,51823.72,5,1,1,7,Potential Loyalists
2308,15773.0,5,10,635.6800000000001,5,1,1,7,Potential Loyalists
2309,15774.0,68,25,270.8,1,2,1,4,Lost Customers
2310,15775.0,244,7,104.9,1,5,2,8,Loyal Customers
2311,15776.0,132,18,241.62,1,4,2,7,Potential Loyalists
2312,15777.0,240,22,1021.61,1,5,2,8,Loyal Customers
2313,15780.0,183,29,475.28000000000003,1,5,2,8,Loyal Customers
2314,15781.0,24,21,333.56,3,1,1,5,At Risk
2315,15782.0,9,44,2593.94,4,1,1,6,Potential Loyalists
2316,15783.0,10,14,246.3,4,1,1,6,Potential Loyalists
2317,15785.0,29,87,2303.75,3,1,1,5,At Risk
2318,15786.0,43,280,4834.2,2,2,1,5,At Risk
2319,15787.0,25,206,948.05,3,1,1,5,At Risk
2320,15789.0,357,25,351.3,1,5,3,9,Best Customers
2321,15790.0,9,35,220.85,4,1,1,6,Potential Loyalists
2322,15791.0,43,76,1604.44,2,2,1,5,At Risk
2323,15793.0,8,13,948.96,4,1,1,6,Potential Loyalists
2324,15795.0,149,42,610.01,1,4,2,7,Potential Loyalists
2325,15796.0,0,133,2707.61,5,1,1,7,Potential Loyalists
2326,15797.0,112,7,2192.4,1,4,2,7,Potential Loyalists
2327,15799.0,75,98,884.14,1,3,1,5,At Risk
2328,15800.0,106,119,699.08,1,4,2,7,Potential Loyalists
2329,15801.0,45,69,1042.19,2,2,1,5,At Risk
2330,15803.0,50,8,415.82000000000005,1,2,1,4,Lost Customers
2331,15804.0,0,274,3848.55,5,1,1,7,Potential Loyalists
2332,15805.0,22,307,5452.17,3,1,1,5,At Risk
2333,15806.0,45,31,784.58,2,2,1,5,At Risk
2334,15807.0,49,48,903.9,1,2,1,4,Lost Customers
2335,15808.0,305,210,3724.77,1,5,3,9,Best Customers
2336,15809.0,35,43,399.21,2,1,1,4,Lost Customers
2337,15810.0,78,112,1145.43,1,3,1,5,At Risk
2338,15811.0,16,139,2171.32,3,1,1,5,At Risk
2339,15812.0,106,41,1801.14,1,4,2,7,Potential Loyalists
2340,15813.0,207,40,1303.9099999999999,1,5,2,8,Loyal Customers
2341,15814.0,2,74,1842.73,5,1,1,7,Potential Loyalists
2342,15815.0,63,49,2100.6,1,2,1,4,Lost Customers
2343,15819.0,48,123,1905.45,1,2,1,4,Lost Customers
2344,15820.0,319,17,206.98,1,5,3,9,Best Customers
2345,15821.0,43,62,570.96,2,2,1,5,At Risk
2346,15822.0,2,33,885.47,5,1,1,7,Potential Loyalists
2348,15825.0,171,20,532.94,1,5,2,8,Loyal Customers
2349,15826.0,50,69,1649.3600000000001,1,2,1,4,Lost Customers
2350,15827.0,72,133,1648.54,1,2,1,4,Lost Customers
2351,15829.0,98,51,636.14,1,3,1,5,At Risk
2352,15830.0,28,41,547.7,3,1,1,5,At Risk
2353,15831.0,57,69,747.76,1,2,1,4,Lost Customers
2354,15832.0,253,54,836.79,1,5,2,8,Loyal Customers
2355,15834.0,69,275,2082.4,1,2,1,4,Lost Customers
2356,15835.0,43,50,954.09,2,2,1,5,At Risk
2357,15836.0,44,12,117.47,2,2,1,5,At Risk
2358,15837.0,64,24,391.98,1,2,1,4,Lost Customers
2359,15838.0,10,168,33362.28,4,1,1,6,Potential Loyalists
2360,15839.0,24,65,1020.74,3,1,1,5,At Risk
2361,15840.0,58,28,345.65999999999997,1,2,1,4,Lost Customers
2362,15841.0,63,50,1209.1,1,2,1,4,Lost Customers
2363,15843.0,303,8,118.95,1,5,3,9,Best Customers
2364,15844.0,45,11,130.73999999999998,2,2,1,5,At Risk
2365,15845.0,17,140,3650.87,3,1,1,5,At Risk
2366,15847.0,37,22,389.27,2,1,1,4,Lost Customers
2367,15850.0,18,97,238.85,3,1,1,5,At Risk
2368,15852.0,186,22,160.71,1,5,2,8,Loyal Customers
2369,15853.0,51,30,110.8,1,2,1,4,Lost Customers
2370,15854.0,3,140,2974.65,5,1,1,7,Potential Loyalists
2371,15855.0,136,80,712.24,1,4,2,7,Potential Loyalists
2372,15856.0,3,652,16172.41,5,1,1,7,Potential Loyalists
2373,15857.0,18,14,297.0,3,1,1,5,At Risk
2374,15858.0,15,191,1438.85,3,1,1,5,At Risk
2375,15860.0,40,142,977.21,2,1,1,4,Lost Customers
2376,15861.0,11,547,3000.36,4,1,1,6,Potential Loyalists
2377,15862.0,7,147,832.88,5,1,1,7,Potential Loyalists
2378,15863.0,25,18,68.84,3,1,1,5,At Risk
2379,15864.0,21,24,1769.78,3,1,1,5,At Risk
2380,15865.0,40,40,895.13,2,1,1,4,Lost Customers
2381,15866.0,100,45,230.53,1,3,2,6,Potential Loyalists
2382,15867.0,4,461,3791.25,5,1,1,7,Potential Loyalists
2383,15869.0,276,15,149.64,1,5,2,8,Loyal Customers
2384,15870.0,32,76,354.09000000000003,2,1,1,4,Lost Customers
2385,15872.0,14,128,360.93,4,1,1,6,Potential Loyalists
2386,15874.0,62,137,4330.67,1,2,1,4,Lost Customers
2387,15877.0,1,131,440.78,5,1,1,7,Potential Loyalists
2388,15880.0,368,106,313.28000000000003,1,5,3,9,Best Customers
2389,15881.0,311,32,438.24,1,5,3,9,Best Customers
2390,15882.0,198,23,493.08000000000004,1,5,2,8,Loyal Customers
2391,15883.0,1,49,396.48,5,1,1,7,Potential Loyalists
2392,15885.0,92,16,349.35,1,3,1,5,At Risk
2393,15886.0,59,12,181.09,1,2,1,4,Lost Customers
2394,15888.0,79,12,135.6,1,3,1,5,At Risk
2395,15889.0,156,91,427.57,1,5,2,8,Loyal Customers
2396,15891.0,226,61,521.97,1,5,2,8,Loyal Customers
2397,15894.0,252,40,262.9,1,5,2,8,Loyal Customers
2398,15895.0,149,11,179.17,1,4,2,7,Potential Loyalists
2399,15897.0,193,24,222.05,1,5,2,8,Loyal Customers
2400,15898.0,0,87,1384.68,5,1,1,7,Potential Loyalists
2401,15899.0,368,4,56.25,1,5,3,9,Best Customers
2402,15900.0,23,51,351.11,3,1,1,5,At Risk
2403,15901.0,16,114,361.9,3,1,1,5,At Risk
2404,15903.0,9,75,5126.34,4,1,1,6,Potential Loyalists
2405,15904.0,7,30,164.68,5,1,1,7,Potential Loyalists
2406,15906.0,19,151,1521.79,3,1,1,5,At Risk
2407,15907.0,3,248,966.6,5,1,1,7,Potential Loyalists
2408,15909.0,173,7,191.94,1,5,2,8,Loyal Customers
2409,15910.0,0,267,1232.18,5,1,1,7,Potential Loyalists
2410,15912.0,177,19,264.62,1,5,2,8,Loyal Customers
2411,15916.0,15,160,1491.24,3,1,1,5,At Risk
2412,15917.0,247,12,123.1,1,5,2,8,Loyal Customers
2413,15918.0,190,40,334.23,1,5,2,8,Loyal Customers
2414,15919.0,19,143,639.89,3,1,1,5,At Risk
2415,15920.0,153,58,163.55,1,5,2,8,Loyal Customers
2416,15921.0,172,25,336.03000000000003,1,5,2,8,Loyal Customers
2417,15922.0,371,12,363.6,1,5,3,9,Best Customers
2418,15923.0,372,21,127.08,1,5,3,9,Best Customers
2419,15925.0,193,12,207.15,1,5,2,8,Loyal Customers
2420,15930.0,66,21,426.63,1,2,1,4,Lost Customers
2421,15932.0,3,119,2461.85,5,1,1,7,Potential Loyalists
2422,15933.0,20,74,1107.46,3,1,1,5,At Risk
2423,15935.0,238,11,108.03999999999999,1,5,2,8,Loyal Customers
2424,15937.0,63,7,145.35,1,2,1,4,Lost Customers
2425,15938.0,111,18,404.58000000000004,1,4,2,7,Potential Loyalists
2426,15939.0,89,76,6087.26,1,3,1,5,At Risk
2427,15940.0,310,1,35.8,1,5,3,9,Best Customers
2428,15942.0,133,14,337.44,1,4,2,7,Potential Loyalists
2429,15944.0,276,6,325.1,1,5,2,8,Loyal Customers
2430,15945.0,364,2,181.0,1,5,3,9,Best Customers
2431,15947.0,82,29,1708.24,1,3,1,5,At Risk
2432,15948.0,7,60,955.24,5,1,1,7,Potential Loyalists
2433,15949.0,16,19,364.72,3,1,1,5,At Risk
2434,15950.0,1,103,1705.26,5,1,1,7,Potential Loyalists
2435,15951.0,0,43,669.57,5,1,1,7,Potential Loyalists
2436,15952.0,33,91,806.57,2,1,1,4,Lost Customers
2437,15953.0,14,103,1634.53,4,1,1,6,Potential Loyalists
2438,15955.0,23,185,4389.81,3,1,1,5,At Risk
2439,15957.0,31,42,428.89,2,1,1,4,Lost Customers
2440,15958.0,73,7,104.35,1,2,1,4,Lost Customers
2441,15963.0,19,28,470.76,3,1,1,5,At Risk
2442,15965.0,16,122,845.64,3,1,1,5,At Risk
2443,15967.0,22,84,418.83,3,1,1,5,At Risk
2444,15969.0,2,21,582.9,5,1,1,7,Potential Loyalists
2445,15970.0,303,11,314.09999999999997,1,5,3,9,Best Customers
2446,15971.0,17,34,4194.9,3,1,1,5,At Risk
2447,15973.0,235,6,99.77000000000002,1,5,2,8,Loyal Customers
2448,15974.0,38,177,3429.55,2,1,1,4,Lost Customers
2449,15975.0,83,24,371.01,1,3,1,5,At Risk
2450,15976.0,164,98,430.94,1,5,2,8,Loyal Customers
2451,15977.0,16,65,1054.73,3,1,1,5,At Risk
2452,15978.0,76,49,1098.78,1,3,1,5,At Risk
2453,15980.0,88,43,2398.86,1,3,1,5,At Risk
2454,15981.0,24,97,3408.48,3,1,1,5,At Risk
2455,15983.0,21,113,1475.02,3,1,1,5,At Risk
2456,15984.0,2,275,2816.9700000000003,5,1,1,7,Potential Loyalists
2457,15985.0,122,38,1037.42,1,4,2,7,Potential Loyalists
2458,15986.0,29,14,168.11999999999998,3,1,1,5,At Risk
2459,15987.0,11,140,1451.28,4,1,1,6,Potential Loyalists
2460,15988.0,18,27,158.03,3,1,1,5,At Risk
2461,15990.0,43,52,792.11,2,2,1,5,At Risk
2462,15992.0,3,3,41.989999999999995,5,1,1,7,Potential Loyalists
2463,15993.0,8,559,2748.12,4,1,1,6,Potential Loyalists
2464,15994.0,54,35,427.07,1,2,1,4,Lost Customers
2465,15996.0,87,131,1044.78,1,3,1,5,At Risk
2466,15998.0,36,509,3084.17,2,1,1,4,Lost Customers
2467,16000.0,2,9,12393.7,5,1,1,7,Potential Loyalists
2468,16003.0,29,103,2735.37,3,1,1,5,At Risk
2469,16005.0,11,218,615.39,4,1,1,6,Potential Loyalists
2470,16006.0,210,8,101.4,1,5,2,8,Loyal Customers
2471,16007.0,47,385,1701.94,2,2,1,5,At Risk
2472,16008.0,23,33,478.78,3,1,1,5,At Risk
2473,16009.0,21,90,992.71,3,1,1,5,At Risk
2474,16010.0,245,86,407.5,1,5,2,8,Loyal Customers
2475,16011.0,7,212,3362.71,5,1,1,7,Potential Loyalists
2476,16012.0,34,94,1415.29,2,1,1,4,Lost Customers
2477,16013.0,3,149,33453.45,5,1,1,7,Potential Loyalists
2478,16014.0,35,148,653.13,2,1,1,4,Lost Customers
2479,16015.0,3,183,690.25,5,1,1,7,Potential Loyalists
2480,16016.0,2,237,1483.31,5,1,1,7,Potential Loyalists
2481,16017.0,46,32,211.88,2,2,1,5,At Risk
2482,16018.0,38,28,408.9,2,1,1,4,Lost Customers
2483,16019.0,1,165,3450.24,5,1,1,7,Potential Loyalists
2484,16020.0,16,46,851.01,3,1,1,5,At Risk
2485,16022.0,259,76,628.28,1,5,2,8,Loyal Customers
2486,16023.0,45,101,719.8100000000001,2,2,1,5,At Risk
2487,16024.0,11,62,245.96,4,1,1,6,Potential Loyalists
2488,16025.0,29,28,439.65999999999997,3,1,1,5,At Risk
2489,16026.0,42,32,236.09,2,2,1,5,At Risk
2490,16027.0,91,16,934.62,1,3,1,5,At Risk
2491,16029.0,38,264,58193.85,2,1,1,4,Lost Customers
2492,16030.0,309,29,331.24,1,5,3,9,Best Customers
2493,16031.0,91,100,548.94,1,3,1,5,At Risk
2494,16033.0,5,1152,8727.61,5,1,1,7,Potential Loyalists
2495,16034.0,195,22,437.7,1,5,2,8,Loyal Customers
2496,16036.0,86,55,758.9200000000001,1,3,1,5,At Risk
2497,16037.0,269,39,855.02,1,5,2,8,Loyal Customers
2498,16038.0,7,28,454.33,5,1,1,7,Potential Loyalists
2499,16040.0,64,65,1313.55,1,2,1,4,Lost Customers
2500,16041.0,30,6,3166.4,3,1,1,5,At Risk
2501,16042.0,21,75,1147.37,3,1,1,5,At Risk
2502,16043.0,37,39,773.99,2,1,1,4,Lost Customers
2503,16045.0,119,83,1340.7,1,4,2,7,Potential Loyalists
2504,16048.0,85,9,243.69000000000003,1,3,1,5,At Risk
2505,16049.0,39,312,1111.79,2,1,1,4,Lost Customers
2506,16050.0,173,10,137.9,1,5,2,8,Loyal Customers
2507,16052.0,53,34,362.06,1,2,1,4,Lost Customers
2508,16053.0,32,84,1511.95,2,1,1,4,Lost Customers
2509,16054.0,144,70,783.9,1,4,2,7,Potential Loyalists
2510,16055.0,220,8,134.8,1,5,2,8,Loyal Customers
2511,16056.0,44,68,664.85,2,2,1,5,At Risk
2512,16057.0,3,134,2140.2200000000003,5,1,1,7,Potential Loyalists
2513,16059.0,65,180,1459.8600000000001,1,2,1,4,Lost Customers
2515,16062.0,9,64,1153.62,4,1,1,6,Potential Loyalists
2516,16063.0,259,23,335.32,1,5,2,8,Loyal Customers
2517,16065.0,364,74,372.09,1,5,3,9,Best Customers
2518,16066.0,16,102,1521.87,3,1,1,5,At Risk
2519,16070.0,21,33,852.15,3,1,1,5,At Risk
2520,16071.0,44,21,326.24,2,2,1,5,At Risk
2521,16072.0,287,23,584.3199999999999,1,5,2,8,Loyal Customers
2522,16073.0,291,2,94.35000000000001,1,5,2,8,Loyal Customers
2523,16076.0,2,131,2173.53,5,1,1,7,Potential Loyalists
2524,16078.0,283,1,79.2,1,5,2,8,Loyal Customers
2525,16079.0,16,21,1352.0,3,1,1,5,At Risk
2526,16080.0,81,11,176.6,1,3,1,5,At Risk
2527,16081.0,55,227,2806.9,1,2,1,4,Lost Customers
2528,16083.0,100,31,1317.62,1,3,2,6,Potential Loyalists
2529,16084.0,298,38,436.18,1,5,2,8,Loyal Customers
2530,16085.0,22,167,981.51,3,1,1,5,At Risk
2531,16086.0,58,40,1119.31,1,2,1,4,Lost Customers
2532,16091.0,154,18,315.06,1,5,2,8,Loyal Customers
2533,16092.0,98,53,779.36,1,3,1,5,At Risk
2534,16093.0,106,1,17.0,1,4,2,7,Potential Loyalists
2535,16094.0,11,67,1041.83,4,1,1,6,Potential Loyalists
2536,16096.0,263,12,320.62,1,5,2,8,Loyal Customers
2537,16097.0,239,10,185.04999999999998,1,5,2,8,Loyal Customers
2538,16098.0,87,67,2005.63,1,3,1,5,At Risk
2539,16099.0,49,39,731.9,1,2,1,4,Lost Customers
2540,16101.0,8,83,1245.96,4,1,1,6,Potential Loyalists
2541,16102.0,41,57,1842.14,2,1,1,4,Lost Customers
2542,16103.0,6,48,1429.64,5,1,1,7,Potential Loyalists
2543,16104.0,61,29,302.36,1,2,1,4,Lost Customers
2544,16105.0,248,13,336.96,1,5,2,8,Loyal Customers
2545,16106.0,65,6,108.38,1,2,1,4,Lost Customers
2546,16107.0,17,31,3204.1600000000003,3,1,1,5,At Risk
2547,16108.0,84,49,816.1,1,3,1,5,At Risk
2548,16109.0,218,18,611.88,1,5,2,8,Loyal Customers
2549,16110.0,44,354,1337.48,2,2,1,5,At Risk
2550,16112.0,142,16,195.74,1,4,2,7,Potential Loyalists
2551,16113.0,182,30,161.38,1,5,2,8,Loyal Customers
2552,16114.0,170,8,135.75000000000003,1,5,2,8,Loyal Customers
2553,16115.0,9,284,1667.97,4,1,1,6,Potential Loyalists
2554,16116.0,205,35,592.88,1,5,2,8,Loyal Customers
2555,16117.0,189,30,232.21,1,5,2,8,Loyal Customers
2556,16119.0,7,16,423.36,5,1,1,7,Potential Loyalists
2557,16120.0,58,32,1294.14,1,2,1,4,Lost Customers
2558,16121.0,56,212,867.11,1,2,1,4,Lost Customers
2559,16122.0,72,38,684.42,1,2,1,4,Lost Customers
2560,16123.0,51,16,307.78,1,2,1,4,Lost Customers
2561,16124.0,315,16,187.15,1,5,3,9,Best Customers
2562,16125.0,366,13,289.35,1,5,3,9,Best Customers
2563,16126.0,28,117,6287.77,3,1,1,5,At Risk
2564,16127.0,38,40,656.25,2,1,1,4,Lost Customers
2565,16128.0,17,89,1880.22,3,1,1,5,At Risk
2566,16131.0,51,78,3506.54,1,2,1,4,Lost Customers
2567,16133.0,3,364,14305.66,5,1,1,7,Potential Loyalists
2568,16134.0,21,38,603.69,3,1,1,5,At Risk
2569,16135.0,262,21,517.55,1,5,2,8,Loyal Customers
2570,16136.0,59,37,709.38,1,2,1,4,Lost Customers
2572,16139.0,18,31,635.41,3,1,1,5,At Risk
2573,16140.0,52,36,708.1800000000001,1,2,1,4,Lost Customers
2574,16141.0,87,30,620.4,1,3,1,5,At Risk
2575,16142.0,249,37,535.34,1,5,2,8,Loyal Customers
2576,16143.0,2,118,2419.84,5,1,1,7,Potential Loyalists
2577,16144.0,246,1,175.2,1,5,2,8,Loyal Customers
2578,16145.0,8,237,3741.98,4,1,1,6,Potential Loyalists
2579,16146.0,156,29,734.13,1,5,2,8,Loyal Customers
2580,16147.0,133,22,375.0,1,4,2,7,Potential Loyalists
2581,16148.0,295,1,76.32000000000001,1,5,2,8,Loyal Customers
2582,16149.0,4,18,280.52,5,1,1,7,Potential Loyalists
2583,16150.0,38,136,1906.07,2,1,1,4,Lost Customers
2584,16152.0,268,29,1829.04,1,5,2,8,Loyal Customers
2585,16153.0,49,89,1824.23,1,2,1,4,Lost Customers
2586,16156.0,8,138,3032.2400000000002,4,1,1,6,Potential Loyalists
2587,16157.0,15,19,644.24,3,1,1,5,At Risk
2588,16159.0,281,14,348.2,1,5,2,8,Loyal Customers
2589,16160.0,63,22,1009.4499999999999,1,2,1,4,Lost Customers
2590,16161.0,1,501,5396.72,5,1,1,7,Potential Loyalists
2591,16162.0,251,2,37.4,1,5,2,8,Loyal Customers
2592,16163.0,224,7,441.59999999999997,1,5,2,8,Loyal Customers
2593,16164.0,16,35,802.53,3,1,1,5,At Risk
2594,16168.0,10,99,3770.6,4,1,1,6,Potential Loyalists
2595,16169.0,7,85,1822.97,5,1,1,7,Potential Loyalists
2596,16170.0,50,127,1880.4199999999998,1,2,1,4,Lost Customers
2597,16171.0,58,3,73.19999999999999,1,2,1,4,Lost Customers
2598,16172.0,94,69,1140.21,1,3,1,5,At Risk
2599,16173.0,15,87,1406.57,3,1,1,5,At Risk
2600,16174.0,125,23,1009.55,1,4,2,7,Potential Loyalists
2601,16175.0,93,58,1037.59,1,3,1,5,At Risk
2602,16177.0,49,15,331.95,1,2,1,4,Lost Customers
2603,16178.0,137,8,197.9,1,4,2,7,Potential Loyalists
2604,16179.0,60,11,215.83,1,2,1,4,Lost Customers
2605,16180.0,99,176,10217.48,1,3,1,5,At Risk
2606,16181.0,72,11,305.54,1,2,1,4,Lost Customers
2607,16182.0,71,28,6617.65,1,2,1,4,Lost Customers
2608,16183.0,66,15,338.71000000000004,1,2,1,4,Lost Customers
2609,16184.0,63,46,1155.54,1,2,1,4,Lost Customers
2610,16185.0,16,31,529.41,3,1,1,5,At Risk
2611,16186.0,22,219,3991.94,3,1,1,5,At Risk
2612,16187.0,31,297,6841.24,2,1,1,4,Lost Customers
2613,16188.0,44,67,981.86,2,2,1,5,At Risk
2614,16189.0,15,11,215.48,3,1,1,5,At Risk
2615,16190.0,39,6,215.08,2,1,1,4,Lost Customers
2616,16191.0,2,150,4916.57,5,1,1,7,Potential Loyalists
2617,16193.0,236,19,314.45,1,5,2,8,Loyal Customers
2618,16198.0,74,14,400.68,1,2,1,4,Lost Customers
2619,16200.0,3,179,1080.6200000000001,5,1,1,7,Potential Loyalists
2620,16201.0,2,115,1821.52,5,1,1,7,Potential Loyalists
2621,16202.0,360,18,365.27,1,5,3,9,Best Customers
2622,16203.0,58,36,589.15,1,2,1,4,Lost Customers
2623,16204.0,22,57,405.71,3,1,1,5,At Risk
2624,16205.0,30,97,754.78,3,1,1,5,At Risk
2625,16206.0,54,63,537.0600000000001,1,2,1,4,Lost Customers
2626,16207.0,24,19,394.38,3,1,1,5,At Risk
2627,16208.0,44,66,664.26,2,2,1,5,At Risk
2628,16209.0,88,46,2262.62,1,3,1,5,At Risk
2629,16210.0,1,122,21076.3,5,1,1,7,Potential Loyalists
2630,16211.0,80,24,542.77,1,3,1,5,At Risk
2631,16212.0,18,43,681.19,3,1,1,5,At Risk
2632,16213.0,78,6,159.0,1,3,1,5,At Risk
2633,16214.0,170,44,1062.75,1,5,2,8,Loyal Customers
2634,16215.0,80,14,242.35,1,3,1,5,At Risk
2635,16216.0,266,37,914.9300000000001,1,5,2,8,Loyal Customers
2636,16217.0,234,18,266.45000000000005,1,5,2,8,Loyal Customers
2637,16218.0,29,90,3054.87,3,1,1,5,At Risk
2638,16221.0,36,97,864.86,2,1,1,4,Lost Customers
2639,16222.0,317,137,846.72,1,5,3,9,Best Customers
2640,16224.0,56,96,1295.3,1,2,1,4,Lost Customers
2641,16225.0,44,134,1096.32,2,2,1,5,At Risk
2642,16226.0,202,8,255.12,1,5,2,8,Loyal Customers
2643,16227.0,218,7,308.32000000000005,1,5,2,8,Loyal Customers
2644,16229.0,86,47,1010.6,1,3,1,5,At Risk
2645,16230.0,189,35,542.03,1,5,2,8,Loyal Customers
2646,16232.0,32,38,983.23,2,1,1,4,Lost Customers
2647,16233.0,70,25,422.13,1,2,1,4,Lost Customers
2648,16235.0,40,47,848.41,2,1,1,4,Lost Customers
2649,16236.0,77,20,432.2,1,3,1,5,At Risk
2650,16239.0,56,21,372.9,1,2,1,4,Lost Customers
2651,16240.0,7,142,3693.81,5,1,1,7,Potential Loyalists
2652,16241.0,9,662,2607.87,4,1,1,6,Potential Loyalists
2653,16242.0,7,295,3598.26,5,1,1,7,Potential Loyalists
2654,16243.0,33,51,409.1,2,1,1,4,Lost Customers
2655,16244.0,211,91,1522.75,1,5,2,8,Loyal Customers
2656,16245.0,23,93,1352.36,3,1,1,5,At Risk
2657,16247.0,169,16,114.56,1,5,2,8,Loyal Customers
2658,16248.0,61,7,152.94,1,2,1,4,Lost Customers
2659,16249.0,52,69,1800.07,1,2,1,4,Lost Customers
2660,16250.0,260,24,389.44,1,5,2,8,Loyal Customers
2662,16253.0,66,123,3683.86,1,2,1,4,Lost Customers
2663,16255.0,16,274,2609.3,3,1,1,5,At Risk
2664,16256.0,257,14,732.63,1,5,2,8,Loyal Customers
2665,16257.0,176,2,46.95,1,5,2,8,Loyal Customers
2666,16258.0,44,135,5203.51,2,2,1,5,At Risk
2667,16260.0,50,18,1035.45,1,2,1,4,Lost Customers
2668,16261.0,16,124,746.83,3,1,1,5,At Risk
2670,16265.0,8,260,5423.15,4,1,1,6,Potential Loyalists
2671,16266.0,73,61,861.89,1,2,1,4,Lost Customers
2672,16268.0,70,45,667.65,1,2,1,4,Lost Customers
2673,16270.0,352,54,1141.24,1,5,3,9,Best Customers
2674,16271.0,15,133,1408.29,3,1,1,5,At Risk
2675,16272.0,116,25,411.7,1,4,2,7,Potential Loyalists
2676,16274.0,372,65,337.75,1,5,3,9,Best Customers
2677,16275.0,196,33,559.87,1,5,2,8,Loyal Customers
2678,16276.0,176,6,810.6,1,5,2,8,Loyal Customers
2679,16278.0,22,25,537.83,3,1,1,5,At Risk
2680,16279.0,20,109,1496.68,3,1,1,5,At Risk
2681,16281.0,71,17,2062.06,1,2,1,4,Lost Customers
2682,16282.0,339,11,168.3,1,5,3,9,Best Customers
2683,16283.0,5,167,1529.81,5,1,1,7,Potential Loyalists
2684,16284.0,30,109,823.97,3,1,1,5,At Risk
2685,16287.0,169,8,142.5,1,5,2,8,Loyal Customers
2686,16292.0,116,19,280.9,1,4,2,7,Potential Loyalists
2687,16293.0,8,120,2236.7400000000002,4,1,1,6,Potential Loyalists
2688,16295.0,9,79,1328.55,4,1,1,6,Potential Loyalists
2689,16297.0,249,22,278.55,1,5,2,8,Loyal Customers
2690,16298.0,22,27,598.2,3,1,1,5,At Risk
2691,16302.0,107,12,212.82,1,4,2,7,Potential Loyalists
2692,16303.0,25,167,5305.83,3,1,1,5,At Risk
2693,16305.0,138,22,361.21999999999997,1,4,2,7,Potential Loyalists
2694,16306.0,213,44,602.27,1,5,2,8,Loyal Customers
2695,16308.0,37,4,2560.0,2,1,1,4,Lost Customers
2696,16309.0,91,44,686.67,1,3,1,5,At Risk
2697,16311.0,17,37,616.26,3,1,1,5,At Risk
2698,16313.0,2,16,274.15,5,1,1,7,Potential Loyalists
2699,16315.0,330,14,226.37,1,5,3,9,Best Customers
2700,16316.0,63,156,2755.56,1,2,1,4,Lost Customers
2701,16317.0,119,69,1341.65,1,4,2,7,Potential Loyalists
2702,16318.0,34,19,328.15,2,1,1,4,Lost Customers
2703,16319.0,217,3,404.40000000000003,1,5,2,8,Loyal Customers
2704,16322.0,0,37,326.75,5,1,1,7,Potential Loyalists
2705,16323.0,195,1,207.50000000000003,1,5,2,8,Loyal Customers
2706,16324.0,127,118,428.68,1,4,2,7,Potential Loyalists
2707,16325.0,43,20,510.54,2,2,1,5,At Risk
2708,16326.0,5,320,3085.96,5,1,1,7,Potential Loyalists
2709,16327.0,13,318,3813.62,4,1,1,6,Potential Loyalists
2710,16330.0,17,41,242.21,3,1,1,5,At Risk
2711,16332.0,27,154,1583.2,3,1,1,5,At Risk
2712,16333.0,7,45,26626.8,5,1,1,7,Potential Loyalists
2713,16337.0,36,10,151.05,2,1,1,4,Lost Customers
2714,16338.0,156,11,214.8,1,5,2,8,Loyal Customers
2715,16339.0,283,20,109.95,1,5,2,8,Loyal Customers
2716,16340.0,106,153,549.07,1,4,2,7,Potential Loyalists
2717,16341.0,24,84,1959.38,3,1,1,5,At Risk
2718,16342.0,74,15,322.41,1,2,1,4,Lost Customers
2719,16343.0,15,47,370.48,3,1,1,5,At Risk
2720,16344.0,157,2,101.10000000000001,1,5,2,8,Loyal Customers
2721,16345.0,43,38,575.41,2,2,1,5,At Risk
2722,16347.0,10,92,887.65,4,1,1,6,Potential Loyalists
2723,16348.0,31,234,1467.11,2,1,1,4,Lost Customers
2724,16349.0,290,9,53.5,1,5,2,8,Loyal Customers
2725,16350.0,20,60,1100.47,3,1,1,5,At Risk
2726,16351.0,332,8,153.9,1,5,3,9,Best Customers
2727,16352.0,17,28,494.44,3,1,1,5,At Risk
2728,16353.0,3,94,6675.71,5,1,1,7,Potential Loyalists
2729,16354.0,62,39,395.8,1,2,1,4,Lost Customers
2730,16356.0,197,32,210.32,1,5,2,8,Loyal Customers
2731,16357.0,32,34,658.88,2,1,1,4,Lost Customers
2732,16358.0,0,110,2024.95,5,1,1,7,Potential Loyalists
2733,16359.0,6,70,1460.3700000000001,5,1,1,7,Potential Loyalists
2734,16360.0,4,671,3411.69,5,1,1,7,Potential Loyalists
2735,16361.0,9,106,896.66,4,1,1,6,Potential Loyalists
2736,16362.0,31,90,652.07,2,1,1,4,Lost Customers
2737,16363.0,52,5,109.36000000000001,1,2,1,4,Lost Customers
2738,16364.0,11,53,707.04,4,1,1,6,Potential Loyalists
2739,16365.0,17,51,1540.42,3,1,1,5,At Risk
2740,16366.0,18,18,327.3,3,1,1,5,At Risk
2741,16367.0,36,130,804.49,2,1,1,4,Lost Customers
2742,16368.0,1,76,497.43,5,1,1,7,Potential Loyalists
2743,16369.0,17,116,1551.58,3,1,1,5,At Risk
2744,16370.0,81,228,1320.56,1,3,1,5,At Risk
2745,16372.0,32,97,367.93,2,1,1,4,Lost Customers
2746,16374.0,65,110,465.08,1,2,1,4,Lost Customers
2747,16376.0,8,128,977.52,4,1,1,6,Potential Loyalists
2748,16377.0,266,5,676.2,1,5,2,8,Loyal Customers
2749,16378.0,246,23,362.95,1,5,2,8,Loyal Customers
2750,16379.0,3,109,2131.9,5,1,1,7,Potential Loyalists
2751,16380.0,60,32,1780.59,1,2,1,4,Lost Customers
2752,16383.0,74,102,668.36,1,2,1,4,Lost Customers
2753,16384.0,89,33,584.5,1,3,1,5,At Risk
2754,16385.0,59,59,555.89,1,2,1,4,Lost Customers
2755,16386.0,28,88,317.2,3,1,1,5,At Risk
2756,16387.0,322,4,94.36,1,5,3,9,Best Customers
2757,16389.0,52,35,1362.27,1,2,1,4,Lost Customers
2758,16392.0,269,45,221.19,1,5,2,8,Loyal Customers
2759,16393.0,1,358,2941.05,5,1,1,7,Potential Loyalists
2760,16394.0,49,100,1412.06,1,2,1,4,Lost Customers
2761,16395.0,60,210,1486.9,1,2,1,4,Lost Customers
2762,16398.0,144,86,1631.15,1,4,2,7,Potential Loyalists
2763,16399.0,18,72,406.77,3,1,1,5,At Risk
2764,16400.0,94,29,303.93,1,3,1,5,At Risk
2765,16401.0,0,197,4063.19,5,1,1,7,Potential Loyalists
2766,16402.0,264,60,299.6,1,5,2,8,Loyal Customers
2767,16403.0,301,15,161.04999999999998,1,5,3,9,Best Customers
2768,16404.0,69,23,443.05,1,2,1,4,Lost Customers
2769,16405.0,301,5,167.25,1,5,3,9,Best Customers
2770,16406.0,18,62,163.07,3,1,1,5,At Risk
2771,16407.0,12,172,2126.93,4,1,1,6,Potential Loyalists
2772,16409.0,35,232,2028.88,2,1,1,4,Lost Customers
2773,16411.0,18,45,214.65,3,1,1,5,At Risk
2774,16412.0,53,35,151.83,1,2,1,4,Lost Customers
2775,16413.0,56,31,262.2,1,2,1,4,Lost Customers
2776,16414.0,21,7,126.25,3,1,1,5,At Risk
2777,16415.0,43,54,210.35,2,2,1,5,At Risk
2778,16416.0,26,72,1031.4,3,1,1,5,At Risk
2779,16418.0,44,102,675.27,2,2,1,5,At Risk
2780,16419.0,112,52,959.48,1,4,2,7,Potential Loyalists
2781,16422.0,16,378,34311.0,3,1,1,5,At Risk
2782,16423.0,24,18,346.12,3,1,1,5,At Risk
2783,16424.0,190,6,82.56,1,5,2,8,Loyal Customers
2784,16425.0,301,21,302.7,1,5,3,9,Best Customers
2785,16426.0,1,372,1908.25,5,1,1,7,Potential Loyalists
2786,16427.0,262,9,241.06,1,5,2,8,Loyal Customers
2788,16429.0,105,2,284.55,1,4,2,7,Potential Loyalists
2789,16430.0,56,6,300.85,1,2,1,4,Lost Customers
2790,16431.0,212,83,642.81,1,5,2,8,Loyal Customers
2791,16432.0,63,8,287.40000000000003,1,2,1,4,Lost Customers
2792,16433.0,27,17,184.26,3,1,1,5,At Risk
2793,16434.0,28,109,1522.25,3,1,1,5,At Risk
2794,16438.0,5,132,798.35,5,1,1,7,Potential Loyalists
2795,16440.0,7,282,3640.67,5,1,1,7,Potential Loyalists
2796,16441.0,66,24,381.2,1,2,1,4,Lost Customers
2797,16442.0,1,174,616.79,5,1,1,7,Potential Loyalists
2798,16444.0,45,85,645.72,2,2,1,5,At Risk
2799,16445.0,33,63,230.51,2,1,1,4,Lost Customers
2800,16446.0,0,4,2.8999999999941792,5,1,1,7,Potential Loyalists
2801,16447.0,135,36,259.01,1,4,2,7,Potential Loyalists
2802,16448.0,197,20,188.89000000000001,1,5,2,8,Loyal Customers
2803,16449.0,190,43,674.69,1,5,2,8,Loyal Customers
2804,16450.0,149,11,311.92,1,4,2,7,Potential Loyalists
2805,16451.0,87,14,266.97,1,3,1,5,At Risk
2806,16454.0,63,1,5.9,1,2,1,4,Lost Customers
2807,16455.0,63,99,1841.18,1,2,1,4,Lost Customers
2808,16456.0,98,111,2158.37,1,3,1,5,At Risk
2809,16457.0,217,9,208.36,1,5,2,8,Loyal Customers
2810,16458.0,2,202,3482.7400000000002,5,1,1,7,Potential Loyalists
2811,16460.0,27,135,814.72,3,1,1,5,At Risk
2812,16461.0,177,33,151.42,1,5,2,8,Loyal Customers
2813,16462.0,63,4,102.0,1,2,1,4,Lost Customers
2814,16463.0,20,85,1383.7,3,1,1,5,At Risk
2815,16464.0,19,236,1314.68,3,1,1,5,At Risk
2816,16466.0,33,148,1603.46,2,1,1,4,Lost Customers
2817,16468.0,73,2,74.9,1,2,1,4,Lost Customers
2818,16469.0,23,182,650.43,3,1,1,5,At Risk
2819,16470.0,51,171,757.44,1,2,1,4,Lost Customers
2820,16471.0,274,13,223.95000000000002,1,5,2,8,Loyal Customers
2821,16473.0,164,19,314.86,1,5,2,8,Loyal Customers
2822,16474.0,6,367,1811.31,5,1,1,7,Potential Loyalists
2823,16475.0,87,28,544.3,1,3,1,5,At Risk
2824,16477.0,63,146,2494.46,1,2,1,4,Lost Customers
2825,16478.0,24,17,331.0,3,1,1,5,At Risk
2826,16479.0,9,35,300.83,4,1,1,6,Potential Loyalists
2827,16480.0,75,53,769.29,1,3,1,5,At Risk
2828,16482.0,15,18,220.62,3,1,1,5,At Risk
2829,16483.0,191,19,139.35,1,5,2,8,Loyal Customers
2830,16484.0,173,26,379.4,1,5,2,8,Loyal Customers
2831,16485.0,76,42,363.65,1,3,1,5,At Risk
2832,16488.0,32,31,492.2,2,1,1,4,Lost Customers
2833,16491.0,46,39,731.5,2,2,1,5,At Risk
2834,16493.0,72,62,1329.66,1,2,1,4,Lost Customers
2835,16494.0,296,50,826.53,1,5,2,8,Loyal Customers
2836,16495.0,2,97,684.41,5,1,1,7,Potential Loyalists
2837,16496.0,8,97,1562.22,4,1,1,6,Potential Loyalists
2838,16497.0,49,136,2965.69,1,2,1,4,Lost Customers
2839,16498.0,160,16,86.12,1,5,2,8,Loyal Customers
2840,16499.0,359,22,319.1,1,5,3,9,Best Customers
2841,16500.0,4,11,400.86,5,1,1,7,Potential Loyalists
2842,16503.0,106,86,1421.43,1,4,2,7,Potential Loyalists
2843,16504.0,24,86,484.38,3,1,1,5,At Risk
2844,16505.0,31,4,777.6,2,1,1,4,Lost Customers
2845,16506.0,19,3,90.30000000000001,3,1,1,5,At Risk
2846,16509.0,296,13,363.70000000000005,1,5,2,8,Loyal Customers
2847,16510.0,371,13,248.1,1,5,3,9,Best Customers
2848,16511.0,21,168,948.26,3,1,1,5,At Risk
2849,16513.0,4,35,874.59,5,1,1,7,Potential Loyalists
2850,16515.0,51,113,1627.13,1,2,1,4,Lost Customers
2851,16516.0,29,6,101.69999999999999,3,1,1,5,At Risk
2852,16517.0,276,17,162.7,1,5,2,8,Loyal Customers
2853,16518.0,60,42,480.92,1,2,1,4,Lost Customers
2854,16519.0,24,12,212.98,3,1,1,5,At Risk
2855,16520.0,185,157,1036.62,1,5,2,8,Loyal Customers
2856,16523.0,1,298,9295.67,5,1,1,7,Potential Loyalists
2857,16525.0,1,200,11895.57,5,1,1,7,Potential Loyalists
2858,16526.0,171,15,290.36,1,5,2,8,Loyal Customers
2859,16527.0,80,14,228.06,1,3,1,5,At Risk
2860,16528.0,3,17,244.41,5,1,1,7,Potential Loyalists
2861,16529.0,189,30,455.25,1,5,2,8,Loyal Customers
2862,16531.0,21,77,1244.59,3,1,1,5,At Risk
2863,16532.0,17,4,6748.8,3,1,1,5,At Risk
2864,16533.0,18,181,1026.94,3,1,1,5,At Risk
2865,16535.0,4,31,593.75,5,1,1,7,Potential Loyalists
2866,16536.0,106,56,539.02,1,4,2,7,Potential Loyalists
2867,16539.0,2,45,1388.81,5,1,1,7,Potential Loyalists
2868,16542.0,53,5,119.62,1,2,1,4,Lost Customers
2869,16545.0,164,3,339.3,1,5,2,8,Loyal Customers
2871,16549.0,9,981,4154.64,4,1,1,6,Potential Loyalists
2872,16550.0,108,261,2266.25,1,4,2,7,Potential Loyalists
2873,16551.0,95,32,922.12,1,3,1,5,At Risk
2874,16552.0,242,17,379.73,1,5,2,8,Loyal Customers
2875,16553.0,162,86,5664.57,1,5,2,8,Loyal Customers
2876,16554.0,2,74,641.55,5,1,1,7,Potential Loyalists
2877,16555.0,34,17,285.89,2,1,1,4,Lost Customers
2878,16556.0,66,207,3313.79,1,2,1,4,Lost Customers
2879,16557.0,23,11,281.85,3,1,1,5,At Risk
2880,16558.0,0,474,8257.04,5,1,1,7,Potential Loyalists
2881,16560.0,20,58,816.51,3,1,1,5,At Risk
2882,16561.0,5,31,511.12,5,1,1,7,Potential Loyalists
2883,16563.0,53,19,1077.74,1,2,1,4,Lost Customers
2884,16565.0,363,3,173.7,1,5,3,9,Best Customers
2885,16566.0,14,19,614.01,4,1,1,6,Potential Loyalists
2886,16567.0,193,35,865.6,1,5,2,8,Loyal Customers
2887,16569.0,2,5,124.2,5,1,1,7,Potential Loyalists
2888,16570.0,8,133,3622.95,4,1,1,6,Potential Loyalists
2889,16571.0,2,106,1285.22,5,1,1,7,Potential Loyalists
2890,16572.0,126,58,999.7,1,4,2,7,Potential Loyalists
2891,16573.0,73,46,648.41,1,2,1,4,Lost Customers
2892,16574.0,70,28,451.44,1,2,1,4,Lost Customers
2894,16581.0,154,11,70.44,1,5,2,8,Loyal Customers
2895,16582.0,112,6,313.62,1,4,2,7,Potential Loyalists
2896,16583.0,373,14,233.45,1,5,3,9,Best Customers
2897,16584.0,79,31,908.03,1,3,1,5,At Risk
2898,16586.0,248,8,463.95,1,5,2,8,Loyal Customers
2899,16587.0,231,13,225.15,1,5,2,8,Loyal Customers
2900,16589.0,70,33,459.24,1,2,1,4,Lost Customers
2901,16591.0,68,10,213.5,1,2,1,4,Lost Customers
2902,16592.0,3,222,4073.28,5,1,1,7,Potential Loyalists
2903,16593.0,50,27,330.03,1,2,1,4,Lost Customers
2904,16594.0,74,53,181.09,1,2,1,4,Lost Customers
2905,16595.0,60,85,360.16,1,2,1,4,Lost Customers
2906,16596.0,15,12,250.15,3,1,1,5,At Risk
2907,16597.0,3,7,90.04,5,1,1,7,Potential Loyalists
2908,16598.0,276,11,140.7,1,5,2,8,Loyal Customers
2909,16600.0,3,62,813.52,5,1,1,7,Potential Loyalists
2910,16601.0,40,30,243.63,2,1,1,4,Lost Customers
2911,16602.0,30,32,494.72999999999996,3,1,1,5,At Risk
2912,16603.0,74,34,482.47,1,2,1,4,Lost Customers
2913,16607.0,17,174,3038.67,3,1,1,5,At Risk
2914,16609.0,14,280,5450.96,4,1,1,6,Potential Loyalists
2915,16610.0,218,6,75.66,1,5,2,8,Loyal Customers
2916,16611.0,185,11,120.99,1,5,2,8,Loyal Customers
2917,16612.0,32,66,1187.66,2,1,1,4,Lost Customers
2918,16613.0,69,30,618.59,1,2,1,4,Lost Customers
2919,16614.0,182,26,506.19,1,5,2,8,Loyal Customers
2920,16616.0,14,33,500.42,4,1,1,6,Potential Loyalists
2921,16617.0,235,5,151.85,1,5,2,8,Loyal Customers
2922,16618.0,30,97,2630.64,3,1,1,5,At Risk
2923,16619.0,253,16,204.41,1,5,2,8,Loyal Customers
2924,16620.0,3,9,178.96,5,1,1,7,Potential Loyalists
2925,16621.0,51,29,813.48,1,2,1,4,Lost Customers
2926,16623.0,245,5,129.45,1,5,2,8,Loyal Customers
2927,16624.0,80,48,810.57,1,3,1,5,At Risk
2928,16625.0,274,23,333.08,1,5,2,8,Loyal Customers
2929,16626.0,0,184,4379.65,5,1,1,7,Potential Loyalists
2930,16627.0,78,20,322.8,1,3,1,5,At Risk
2931,16628.0,29,119,2183.04,3,1,1,5,At Risk
2932,16629.0,73,64,417.73,1,2,1,4,Lost Customers
2933,16633.0,16,153,2878.15,3,1,1,5,At Risk
2934,16634.0,222,9,217.9,1,5,2,8,Loyal Customers
2935,16637.0,31,72,1124.59,2,1,1,4,Lost Customers
2936,16638.0,22,95,1676.47,3,1,1,5,At Risk
2937,16639.0,24,52,1169.38,3,1,1,5,At Risk
2938,16641.0,105,12,231.1,1,4,2,7,Potential Loyalists
2939,16642.0,4,35,679.83,5,1,1,7,Potential Loyalists
2940,16643.0,245,27,487.51,1,5,2,8,Loyal Customers
2941,16644.0,177,62,833.78,1,5,2,8,Loyal Customers
2942,16647.0,169,14,214.06,1,5,2,8,Loyal Customers
2943,16648.0,38,21,270.85999999999996,2,1,1,4,Lost Customers
2944,16650.0,71,24,518.42,1,2,1,4,Lost Customers
2945,16652.0,53,123,6654.26,1,2,1,4,Lost Customers
2946,16653.0,15,76,1166.92,3,1,1,5,At Risk
2947,16654.0,140,31,594.97,1,4,2,7,Potential Loyalists
2948,16655.0,17,261,3794.52,3,1,1,5,At Risk
2949,16656.0,21,80,8568.24,3,1,1,5,At Risk
2950,16657.0,9,208,933.62,4,1,1,6,Potential Loyalists
2951,16658.0,367,8,123.24,1,5,3,9,Best Customers
2952,16659.0,188,2,39.12,1,5,2,8,Loyal Customers
2953,16660.0,15,17,810.45,3,1,1,5,At Risk
2954,16665.0,361,9,135.4,1,5,3,9,Best Customers
2955,16666.0,18,32,118.98,3,1,1,5,At Risk
2956,16667.0,67,53,570.13,1,2,1,4,Lost Customers
2957,16668.0,14,20,306.72,4,1,1,6,Potential Loyalists
2958,16669.0,23,158,1370.47,3,1,1,5,At Risk
2959,16670.0,16,262,4022.46,3,1,1,5,At Risk
2960,16671.0,27,6,1692.27,3,1,1,5,At Risk
2961,16672.0,1,116,8119.6900000000005,5,1,1,7,Potential Loyalists
2962,16674.0,54,98,319.61,1,2,1,4,Lost Customers
2963,16676.0,33,92,1558.72,2,1,1,4,Lost Customers
2964,16678.0,2,168,3025.24,5,1,1,7,Potential Loyalists
2965,16679.0,365,3,129.75,1,5,3,9,Best Customers
2966,16680.0,42,10,183.7,2,2,1,5,At Risk
2967,16681.0,72,44,1770.3400000000001,1,2,1,4,Lost Customers
2968,16682.0,4,30,1028.0,5,1,1,7,Potential Loyalists
2969,16684.0,3,280,65920.12,5,1,1,7,Potential Loyalists
2970,16685.0,60,62,324.24,1,2,1,4,Lost Customers
2971,16686.0,46,588,3043.48,2,2,1,5,At Risk
2972,16688.0,0,62,1260.86,5,1,1,7,Potential Loyalists
2973,16689.0,75,15,355.1,1,3,1,5,At Risk
2974,16690.0,43,13,208.63,2,2,1,5,At Risk
2975,16692.0,255,2,1126.0,1,5,2,8,Loyal Customers
2976,16693.0,68,60,482.01,1,2,1,4,Lost Customers
2977,16696.0,134,10,657.9,1,4,2,7,Potential Loyalists
2978,16697.0,240,21,112.75,1,5,2,8,Loyal Customers
2979,16698.0,226,5,1998.0,1,5,2,8,Loyal Customers
2980,16700.0,8,312,5040.0,4,1,1,6,Potential Loyalists
2981,16701.0,8,154,5150.2699999999995,4,1,1,6,Potential Loyalists
2982,16705.0,0,284,13946.130000000001,5,1,1,7,Potential Loyalists
2983,16706.0,36,123,531.35,2,1,1,4,Lost Customers
2984,16708.0,45,27,656.63,2,2,1,5,At Risk
2985,16709.0,84,79,3029.87,1,3,1,5,At Risk
2986,16710.0,18,402,2483.04,3,1,1,5,At Risk
2987,16711.0,2,22,1651.03,5,1,1,7,Potential Loyalists
2988,16712.0,8,446,3637.7799999999997,4,1,1,6,Potential Loyalists
2989,16713.0,18,632,6840.2300000000005,3,1,1,5,At Risk
2990,16714.0,316,93,896.53,1,5,3,9,Best Customers
2991,16715.0,77,19,301.71999999999997,1,3,1,5,At Risk
2992,16716.0,266,3,319.8000000000001,1,5,2,8,Loyal Customers
2993,16717.0,8,236,3278.36,4,1,1,6,Potential Loyalists
2994,16718.0,368,45,623.75,1,5,3,9,Best Customers
2995,16719.0,14,203,1773.92,4,1,1,6,Potential Loyalists
2996,16720.0,25,27,155.24,3,1,1,5,At Risk
2997,16721.0,261,37,292.47,1,5,2,8,Loyal Customers
2998,16722.0,16,228,4711.21,3,1,1,5,At Risk
2999,16723.0,90,43,589.15,1,3,1,5,At Risk
3000,16725.0,301,151,773.62,1,5,3,9,Best Customers
3001,16726.0,25,185,1382.02,3,1,1,5,At Risk
3002,16727.0,363,46,272.82,1,5,3,9,Best Customers
3003,16728.0,45,269,1054.67,2,2,1,5,At Risk
3004,16729.0,35,666,7080.0,2,1,1,4,Lost Customers
3005,16730.0,51,84,702.79,1,2,1,4,Lost Customers
3006,16732.0,31,28,603.75,2,1,1,4,Lost Customers
3007,16734.0,51,53,650.51,1,2,1,4,Lost Customers
3008,16735.0,78,128,2269.21,1,3,1,5,At Risk
3009,16737.0,52,1,417.6,1,2,1,4,Lost Customers
3010,16738.0,297,1,3.75,1,5,2,8,Loyal Customers
3011,16739.0,171,16,312.55,1,5,2,8,Loyal Customers
3013,16743.0,28,193,2191.84,3,1,1,5,At Risk
3014,16744.0,10,242,1304.76,4,1,1,6,Potential Loyalists
3015,16745.0,86,358,7170.7,1,3,1,5,At Risk
3016,16746.0,4,452,6694.31,5,1,1,7,Potential Loyalists
3017,16747.0,24,45,826.96,3,1,1,5,At Risk
3018,16748.0,17,69,1515.9,3,1,1,5,At Risk
3019,16750.0,44,95,623.93,2,2,1,5,At Risk
3020,16751.0,30,25,1764.72,3,1,1,5,At Risk
3021,16752.0,372,9,207.5,1,5,3,9,Best Customers
3022,16753.0,57,34,223.92000000000002,1,2,1,4,Lost Customers
3023,16754.0,371,2,2002.4,1,5,3,9,Best Customers
3024,16755.0,113,176,1484.63,1,4,2,7,Potential Loyalists
3025,16756.0,214,13,239.4,1,5,2,8,Loyal Customers
3026,16757.0,318,7,106.83000000000001,1,5,3,9,Best Customers
3027,16758.0,64,22,369.34000000000003,1,2,1,4,Lost Customers
3028,16759.0,7,43,772.84,5,1,1,7,Potential Loyalists
3029,16761.0,96,13,316.62,1,3,1,5,At Risk
3030,16762.0,19,89,1501.38,3,1,1,5,At Risk
3031,16763.0,184,24,594.9,1,5,2,8,Loyal Customers
3032,16764.0,3,718,2758.25,5,1,1,7,Potential Loyalists
3033,16765.0,293,1,34.0,1,5,2,8,Loyal Customers
3034,16766.0,272,34,1145.6,1,5,2,8,Loyal Customers
3035,16767.0,30,222,5580.6,3,1,1,5,At Risk
3036,16768.0,47,58,458.04,2,2,1,5,At Risk
3037,16769.0,259,40,380.39,1,5,2,8,Loyal Customers
3038,16770.0,57,146,744.9,1,2,1,4,Lost Customers
3039,16771.0,32,254,2234.81,2,1,1,4,Lost Customers
3040,16773.0,56,26,171.59,1,2,1,4,Lost Customers
3041,16774.0,67,49,654.92,1,2,1,4,Lost Customers
3042,16775.0,9,158,1695.66,4,1,1,6,Potential Loyalists
3043,16776.0,59,76,388.28,1,2,1,4,Lost Customers
3044,16777.0,79,50,226.35,1,3,1,5,At Risk
3045,16778.0,73,16,245.94,1,2,1,4,Lost Customers
3046,16779.0,1,344,10454.05,5,1,1,7,Potential Loyalists
3047,16780.0,99,60,425.19,1,3,1,5,At Risk
3048,16781.0,364,19,294.65,1,5,3,9,Best Customers
3049,16782.0,9,197,2242.25,4,1,1,6,Potential Loyalists
3050,16784.0,19,3,107.6,3,1,1,5,At Risk
3051,16788.0,122,154,595.83,1,4,2,7,Potential Loyalists
3052,16789.0,7,5,80.8,5,1,1,7,Potential Loyalists
3053,16790.0,3,95,1520.12,5,1,1,7,Potential Loyalists
3054,16791.0,28,321,1693.53,3,1,1,5,At Risk
3055,16792.0,281,12,110.38,1,5,2,8,Loyal Customers
3056,16793.0,56,16,243.84,1,2,1,4,Lost Customers
3057,16794.0,0,286,1199.49,5,1,1,7,Potential Loyalists
3058,16795.0,364,66,414.88,1,5,3,9,Best Customers
3059,16796.0,88,18,305.62,1,3,1,5,At Risk
3060,16800.0,10,164,1201.49,4,1,1,6,Potential Loyalists
3061,16801.0,162,121,867.8299999999999,1,5,2,8,Loyal Customers
3062,16803.0,64,24,332.3,1,2,1,4,Lost Customers
3063,16804.0,22,60,536.99,3,1,1,5,At Risk
3064,16805.0,173,98,460.59000000000003,1,5,2,8,Loyal Customers
3065,16806.0,102,102,775.54,1,3,2,6,Potential Loyalists
3066,16807.0,142,67,1121.59,1,4,2,7,Potential Loyalists
3067,16808.0,98,23,288.42,1,3,1,5,At Risk
3068,16809.0,22,150,912.74,3,1,1,5,At Risk
3069,16810.0,191,16,275.64,1,5,2,8,Loyal Customers
3070,16811.0,4,28,547.07,5,1,1,7,Potential Loyalists
3071,16812.0,360,15,479.35,1,5,3,9,Best Customers
3072,16813.0,7,449,1692.98,5,1,1,7,Potential Loyalists
3073,16814.0,13,324,6490.7,4,1,1,6,Potential Loyalists
3074,16816.0,102,28,417.06,1,3,2,6,Potential Loyalists
3075,16817.0,2,95,1446.95,5,1,1,7,Potential Loyalists
3076,16818.0,10,191,3317.97,4,1,1,6,Potential Loyalists
3077,16820.0,95,26,497.61,1,3,1,5,At Risk
3078,16823.0,226,38,358.38,1,5,2,8,Loyal Customers
3079,16824.0,15,26,460.64,3,1,1,5,At Risk
3080,16825.0,38,28,775.18,2,1,1,4,Lost Customers
3081,16826.0,50,22,341.7,1,2,1,4,Lost Customers
3082,16828.0,111,7,113.5,1,4,2,7,Potential Loyalists
3083,16829.0,156,11,197.22,1,5,2,8,Loyal Customers
3084,16830.0,38,23,325.91,2,1,1,4,Lost Customers
3085,16832.0,183,12,199.15,1,5,2,8,Loyal Customers
3086,16833.0,0,47,1106.53,5,1,1,7,Potential Loyalists
3087,16834.0,227,24,413.46,1,5,2,8,Loyal Customers
3088,16835.0,127,10,180.85,1,4,2,7,Potential Loyalists
3089,16836.0,39,11,251.87,2,1,1,4,Lost Customers
3090,16837.0,30,166,3167.73,3,1,1,5,At Risk
3091,16838.0,196,26,582.9,1,5,2,8,Loyal Customers
3092,16839.0,8,297,15362.28,4,1,1,6,Potential Loyalists
3093,16841.0,36,117,1774.62,2,1,1,4,Lost Customers
3094,16842.0,63,64,1260.44,1,2,1,4,Lost Customers
3095,16843.0,42,379,10183.82,2,2,1,5,At Risk
3096,16846.0,49,11,214.32,1,2,1,4,Lost Customers
3097,16847.0,42,12,193.44,2,2,1,5,At Risk
3098,16848.0,52,14,281.42,1,2,1,4,Lost Customers
3099,16849.0,186,8,124.57,1,5,2,8,Loyal Customers
3100,16850.0,333,19,332.41,1,5,3,9,Best Customers
3101,16851.0,3,20,342.45,5,1,1,7,Potential Loyalists
3102,16852.0,9,9,144.91,4,1,1,6,Potential Loyalists
3103,16855.0,23,19,328.4,3,1,1,5,At Risk
3104,16856.0,14,2,35.400000000000006,4,1,1,6,Potential Loyalists
3105,16858.0,365,13,345.89000000000004,1,5,3,9,Best Customers
3106,16859.0,105,72,473.14,1,4,2,7,Potential Loyalists
3107,16861.0,59,7,156.06,1,2,1,4,Lost Customers
3108,16863.0,28,28,481.35,3,1,1,5,At Risk
3109,16866.0,140,11,207.74,1,4,2,7,Potential Loyalists
3110,16869.0,22,129,805.62,3,1,1,5,At Risk
3111,16871.0,21,139,2761.4900000000002,3,1,1,5,At Risk
3112,16872.0,76,7,680.02,1,3,1,5,At Risk
3113,16873.0,4,289,7066.31,5,1,1,7,Potential Loyalists
3114,16875.0,63,123,2023.47,1,2,1,4,Lost Customers
3115,16877.0,11,159,853.72,4,1,1,6,Potential Loyalists
3117,16880.0,30,178,1519.08,3,1,1,5,At Risk
3118,16881.0,66,1,432.0,1,2,1,4,Lost Customers
3119,16882.0,66,39,705.12,1,2,1,4,Lost Customers
3120,16883.0,186,38,276.73,1,5,2,8,Loyal Customers
3121,16884.0,37,26,429.84,2,1,1,4,Lost Customers
3122,16885.0,14,101,471.51,4,1,1,6,Potential Loyalists
3123,16887.0,34,37,194.88,2,1,1,4,Lost Customers
3124,16889.0,194,135,1578.67,1,5,2,8,Loyal Customers
3125,16891.0,1,203,809.7,5,1,1,7,Potential Loyalists
3126,16892.0,0,101,496.84000000000003,5,1,1,7,Potential Loyalists
3127,16893.0,366,45,145.93,1,5,3,9,Best Customers
3128,16895.0,64,69,219.14,1,2,1,4,Lost Customers
3129,16897.0,298,44,213.03,1,5,2,8,Loyal Customers
3130,16898.0,25,163,444.46,3,1,1,5,At Risk
3131,16899.0,7,125,1281.56,5,1,1,7,Potential Loyalists
3132,16900.0,11,79,869.2,4,1,1,6,Potential Loyalists
3133,16902.0,115,44,1706.88,1,4,2,7,Potential Loyalists
3134,16903.0,28,60,373.24,3,1,1,5,At Risk
3135,16904.0,3,708,3735.47,5,1,1,7,Potential Loyalists
3136,16905.0,4,209,3085.48,5,1,1,7,Potential Loyalists
3137,16906.0,81,93,579.77,1,3,1,5,At Risk
3138,16907.0,28,151,981.65,3,1,1,5,At Risk
3139,16909.0,63,19,364.14,1,2,1,4,Lost Customers
3140,16910.0,3,547,1510.06,5,1,1,7,Potential Loyalists
3141,16912.0,22,104,2535.73,3,1,1,5,At Risk
3142,16913.0,289,8,113.44,1,5,2,8,Loyal Customers
3143,16914.0,35,38,208.46,2,1,1,4,Lost Customers
3144,16915.0,8,57,621.6800000000001,4,1,1,6,Potential Loyalists
3145,16916.0,23,143,576.26,3,1,1,5,At Risk
3146,16917.0,276,9,391.52,1,5,2,8,Loyal Customers
3147,16918.0,49,130,1043.34,1,2,1,4,Lost Customers
3148,16919.0,155,327,2596.45,1,5,2,8,Loyal Customers
3149,16921.0,60,60,169.79,1,2,1,4,Lost Customers
3150,16923.0,11,696,6666.83,4,1,1,6,Potential Loyalists
3151,16924.0,20,89,739.5,3,1,1,5,At Risk
3152,16926.0,370,14,230.25,1,5,3,9,Best Customers
3153,16927.0,115,6,543.05,1,4,2,7,Potential Loyalists
3154,16928.0,79,212,2773.55,1,3,1,5,At Risk
3155,16929.0,3,77,1295.39,5,1,1,7,Potential Loyalists
3156,16930.0,25,54,380.55,3,1,1,5,At Risk
3157,16931.0,4,898,4604.22,5,1,1,7,Potential Loyalists
3158,16932.0,52,53,161.94,1,2,1,4,Lost Customers
3159,16933.0,0,49,530.08,5,1,1,7,Potential Loyalists
3160,16934.0,54,62,950.9300000000001,1,2,1,4,Lost Customers
3161,16936.0,25,57,262.68,3,1,1,5,At Risk
3162,16938.0,8,242,1903.13,4,1,1,6,Potential Loyalists
3163,16940.0,51,305,3049.88,1,2,1,4,Lost Customers
3164,16942.0,12,283,1894.1100000000001,4,1,1,6,Potential Loyalists
3165,16943.0,211,33,816.73,1,5,2,8,Loyal Customers
3166,16945.0,21,249,4345.5,3,1,1,5,At Risk
3167,16947.0,235,21,406.48,1,5,2,8,Loyal Customers
3168,16948.0,138,19,435.02,1,4,2,7,Potential Loyalists
3169,16949.0,3,61,1161.27,5,1,1,7,Potential Loyalists
3170,16950.0,56,42,1178.56,1,2,1,4,Lost Customers
3171,16951.0,122,87,1262.75,1,4,2,7,Potential Loyalists
3172,16952.0,108,16,167.61,1,4,2,7,Potential Loyalists
3173,16953.0,29,1,20.8,3,1,1,5,At Risk
3174,16954.0,0,54,2085.08,5,1,1,7,Potential Loyalists
3175,16955.0,184,26,493.67,1,5,2,8,Loyal Customers
3176,16956.0,8,18,292.34,4,1,1,6,Potential Loyalists
3177,16957.0,238,16,416.64,1,5,2,8,Loyal Customers
3178,16959.0,86,7,117.35000000000001,1,3,1,5,At Risk
3179,16960.0,38,100,505.1,2,1,1,4,Lost Customers
3180,16961.0,115,14,234.17000000000002,1,4,2,7,Potential Loyalists
3181,16963.0,186,7,110.55000000000001,1,5,2,8,Loyal Customers
3182,16965.0,226,25,192.07,1,5,2,8,Loyal Customers
3183,16966.0,7,30,2148.97,5,1,1,7,Potential Loyalists
3184,16967.0,188,21,319.02,1,5,2,8,Loyal Customers
3185,16968.0,3,31,439.43,5,1,1,7,Potential Loyalists
3186,16969.0,38,42,650.41,2,1,1,4,Lost Customers
3187,16971.0,37,41,357.21,2,1,1,4,Lost Customers
3188,16976.0,266,2,251.51999999999998,1,5,2,8,Loyal Customers
3189,16978.0,77,39,344.33,1,3,1,5,At Risk
3190,16979.0,3,91,1809.05,5,1,1,7,Potential Loyalists
3191,16980.0,254,87,1078.96,1,5,2,8,Loyal Customers
3192,16982.0,60,22,384.06,1,2,1,4,Lost Customers
3193,16983.0,12,149,1920.2,4,1,1,6,Potential Loyalists
3194,16984.0,77,418,4392.42,1,3,1,5,At Risk
3195,16985.0,16,121,5461.62,3,1,1,5,At Risk
3196,16986.0,29,3,1873.2,3,1,1,5,At Risk
3197,16987.0,2,129,1625.05,5,1,1,7,Potential Loyalists
3198,16988.0,4,7,126.12,5,1,1,7,Potential Loyalists
3199,16989.0,6,12,1133.25,5,1,1,7,Potential Loyalists
3200,16990.0,218,1,179.0,1,5,2,8,Loyal Customers
3201,16992.0,10,95,1601.8600000000001,4,1,1,6,Potential Loyalists
3203,16996.0,29,41,1427.46,3,1,1,5,At Risk
3204,16997.0,287,12,702.0,1,5,2,8,Loyal Customers
3205,16998.0,149,5,287.5,1,4,2,7,Potential Loyalists
3206,16999.0,22,23,484.82,3,1,1,5,At Risk
3207,17001.0,0,169,3989.57,5,1,1,7,Potential Loyalists
3208,17002.0,72,50,1487.78,1,2,1,4,Lost Customers
3209,17004.0,45,44,1412.94,2,2,1,5,At Risk
3210,17006.0,4,44,781.78,5,1,1,7,Potential Loyalists
3211,17007.0,50,53,877.4300000000001,1,2,1,4,Lost Customers
3212,17010.0,16,12,185.46,3,1,1,5,At Risk
3213,17011.0,29,15,270.9,3,1,1,5,At Risk
3214,17014.0,7,75,565.58,5,1,1,7,Potential Loyalists
3215,17015.0,28,217,1842.56,3,1,1,5,At Risk
3216,17017.0,2,268,8574.11,5,1,1,7,Potential Loyalists
3217,17018.0,40,16,920.1,2,1,1,4,Lost Customers
3218,17019.0,10,234,1272.61,4,1,1,6,Potential Loyalists
3219,17022.0,30,7,71.0,3,1,1,5,At Risk
3220,17024.0,44,3,95.85,2,2,1,5,At Risk
3221,17025.0,60,9,357.77,1,2,1,4,Lost Customers
3222,17026.0,184,4,154.83,1,5,2,8,Loyal Customers
3223,17027.0,78,155,848.59,1,3,1,5,At Risk
3224,17029.0,110,2,716.0,1,4,2,7,Potential Loyalists
3225,17030.0,63,11,146.87,1,2,1,4,Lost Customers
3226,17031.0,11,22,380.35,4,1,1,6,Potential Loyalists
3227,17033.0,85,28,1030.14,1,3,1,5,At Risk
3228,17034.0,15,32,734.5699999999999,3,1,1,5,At Risk
3229,17035.0,245,32,388.33,1,5,2,8,Loyal Customers
3230,17037.0,77,77,1253.22,1,3,1,5,At Risk
3231,17038.0,29,22,112.4,3,1,1,5,At Risk
3232,17040.0,137,15,449.73,1,4,2,7,Potential Loyalists
3233,17041.0,26,71,1065.77,3,1,1,5,At Risk
3234,17042.0,2,98,1044.3799999999999,5,1,1,7,Potential Loyalists
3235,17043.0,31,102,1735.18,2,1,1,4,Lost Customers
3236,17044.0,8,10,897.4300000000001,4,1,1,6,Potential Loyalists
3237,17045.0,112,22,339.44,1,4,2,7,Potential Loyalists
3238,17046.0,156,22,642.02,1,5,2,8,Loyal Customers
3239,17047.0,84,65,1100.9,1,3,1,5,At Risk
3240,17048.0,114,48,864.32,1,4,2,7,Potential Loyalists
3241,17049.0,2,322,5594.78,5,1,1,7,Potential Loyalists
3242,17050.0,95,316,3228.84,1,3,1,5,At Risk
3243,17051.0,193,43,247.14000000000001,1,5,2,8,Loyal Customers
3244,17052.0,27,92,413.75,3,1,1,5,At Risk
3245,17053.0,128,14,496.38,1,4,2,7,Potential Loyalists
3246,17054.0,27,84,1353.83,3,1,1,5,At Risk
3247,17058.0,81,62,1179.89,1,3,1,5,At Risk
3248,17059.0,29,516,3095.04,3,1,1,5,At Risk
3249,17060.0,265,5,234.24,1,5,2,8,Loyal Customers
3250,17061.0,73,101,5116.13,1,2,1,4,Lost Customers
3251,17062.0,313,70,529.4300000000001,1,5,3,9,Best Customers
3252,17063.0,8,82,1421.59,4,1,1,6,Potential Loyalists
3253,17064.0,58,62,859.35,1,2,1,4,Lost Customers
3254,17068.0,11,296,4525.09,4,1,1,6,Potential Loyalists
3255,17069.0,27,154,2655.2200000000003,3,1,1,5,At Risk
3256,17070.0,113,64,312.14,1,4,2,7,Potential Loyalists
3257,17071.0,8,148,2385.48,4,1,1,6,Potential Loyalists
3258,17073.0,17,173,1444.84,3,1,1,5,At Risk
3259,17075.0,17,80,813.77,3,1,1,5,At Risk
3260,17076.0,35,25,841.0799999999999,2,1,1,4,Lost Customers
3261,17078.0,35,27,375.86,2,1,1,4,Lost Customers
3262,17079.0,77,2,118.80000000000001,1,3,1,5,At Risk
3263,17080.0,21,9,285.5,3,1,1,5,At Risk
3264,17081.0,24,64,290.16,3,1,1,5,At Risk
3265,17082.0,32,81,2003.85,2,1,1,4,Lost Customers
3266,17083.0,108,52,1405.78,1,4,2,7,Potential Loyalists
3267,17084.0,34,162,2949.75,2,1,1,4,Lost Customers
3268,17085.0,122,189,1555.05,1,4,2,7,Potential Loyalists
3269,17086.0,6,96,2050.08,5,1,1,7,Potential Loyalists
3270,17088.0,27,115,1991.01,3,1,1,5,At Risk
3271,17090.0,3,64,2041.8500000000001,5,1,1,7,Potential Loyalists
3272,17091.0,2,198,3802.81,5,1,1,7,Potential Loyalists
3273,17092.0,49,125,1777.78,1,2,1,4,Lost Customers
3274,17094.0,317,15,270.20000000000005,1,5,3,9,Best Customers
3275,17095.0,21,76,1296.36,3,1,1,5,At Risk
3276,17096.0,8,52,992.68,4,1,1,6,Potential Loyalists
3277,17100.0,17,65,971.74,3,1,1,5,At Risk
3278,17101.0,9,42,1621.73,4,1,1,6,Potential Loyalists
3279,17102.0,261,1,25.5,1,5,2,8,Loyal Customers
3280,17105.0,158,90,665.78,1,5,2,8,Loyal Customers
3281,17107.0,32,421,10380.43,2,1,1,4,Lost Customers
3282,17109.0,28,121,869.6800000000001,3,1,1,5,At Risk
3283,17110.0,164,12,163.29999999999998,1,5,2,8,Loyal Customers
3284,17111.0,46,30,248.61,2,2,1,5,At Risk
3285,17114.0,5,135,747.22,5,1,1,7,Potential Loyalists
3286,17115.0,7,43,806.9,5,1,1,7,Potential Loyalists
3287,17117.0,287,9,116.19999999999999,1,5,2,8,Loyal Customers
3288,17118.0,317,10,157.02,1,5,3,9,Best Customers
3289,17119.0,2,38,593.61,5,1,1,7,Potential Loyalists
3290,17120.0,232,18,307.46,1,5,2,8,Loyal Customers
3291,17122.0,118,7,138.32,1,4,2,7,Potential Loyalists
3292,17123.0,161,9,345.3,1,5,2,8,Loyal Customers
3293,17124.0,184,32,298.89,1,5,2,8,Loyal Customers
3294,17125.0,49,40,259.35,1,2,1,4,Lost Customers
3295,17126.0,151,262,991.85,1,5,2,8,Loyal Customers
3296,17128.0,334,14,157.09,1,5,3,9,Best Customers
3297,17131.0,4,134,2463.17,5,1,1,7,Potential Loyalists
3298,17133.0,15,27,4892.240000000001,3,1,1,5,At Risk
3299,17134.0,106,24,425.0,1,4,2,7,Potential Loyalists
3300,17135.0,15,52,1139.73,3,1,1,5,At Risk
3301,17138.0,275,24,380.5,1,5,2,8,Loyal Customers
3302,17139.0,15,487,10585.57,3,1,1,5,At Risk
3303,17140.0,246,20,465.32,1,5,2,8,Loyal Customers
3304,17142.0,238,15,579.0,1,5,2,8,Loyal Customers
3305,17144.0,0,48,984.57,5,1,1,7,Potential Loyalists
3306,17146.0,105,35,749.78,1,4,2,7,Potential Loyalists
3307,17147.0,22,85,1679.64,3,1,1,5,At Risk
3308,17148.0,51,9,124.88,1,2,1,4,Lost Customers
3309,17152.0,194,16,1503.5,1,5,2,8,Loyal Customers
3310,17153.0,23,14,213.78,3,1,1,5,At Risk
3311,17154.0,74,23,329.34,1,2,1,4,Lost Customers
3312,17155.0,17,20,251.7,3,1,1,5,At Risk
3313,17157.0,7,15,306.55,5,1,1,7,Potential Loyalists
3314,17158.0,31,67,1266.97,2,1,1,4,Lost Customers
3315,17159.0,21,102,1534.73,3,1,1,5,At Risk
3316,17160.0,30,229,3518.03,3,1,1,5,At Risk
3317,17162.0,28,105,1707.21,3,1,1,5,At Risk
3318,17163.0,21,5,293.1,3,1,1,5,At Risk
3319,17164.0,32,145,2466.4,2,1,1,4,Lost Customers
3320,17165.0,283,10,158.68,1,5,2,8,Loyal Customers
3321,17166.0,38,14,189.49,2,1,1,4,Lost Customers
3322,17169.0,49,60,816.88,1,2,1,4,Lost Customers
3323,17171.0,288,16,224.91,1,5,2,8,Loyal Customers
3324,17172.0,78,15,317.76,1,3,1,5,At Risk
3325,17173.0,4,87,3755.65,5,1,1,7,Potential Loyalists
3326,17174.0,217,4,59.9,1,5,2,8,Loyal Customers
3327,17175.0,43,64,1430.94,2,2,1,5,At Risk
3328,17176.0,201,15,306.13,1,5,2,8,Loyal Customers
3329,17179.0,177,80,711.79,1,5,2,8,Loyal Customers
3330,17180.0,55,131,780.38,1,2,1,4,Lost Customers
3331,17181.0,56,23,239.92000000000002,1,2,1,4,Lost Customers
3332,17183.0,7,76,3286.91,5,1,1,7,Potential Loyalists
3333,17186.0,46,2,144.0,2,2,1,5,At Risk
3334,17187.0,226,10,203.95,1,5,2,8,Loyal Customers
3335,17188.0,10,89,2275.58,4,1,1,6,Potential Loyalists
3336,17189.0,105,61,384.4,1,4,2,7,Potential Loyalists
3337,17190.0,58,20,249.74,1,2,1,4,Lost Customers
3338,17191.0,27,237,2095.13,3,1,1,5,At Risk
3339,17193.0,35,35,1674.46,2,1,1,4,Lost Customers
3340,17194.0,360,25,226.78,1,5,3,9,Best Customers
3341,17197.0,29,29,1013.01,3,1,1,5,At Risk
3342,17198.0,23,96,692.22,3,1,1,5,At Risk
3343,17201.0,53,40,342.63,1,2,1,4,Lost Customers
3344,17203.0,35,152,3563.85,2,1,1,4,Lost Customers
3345,17204.0,168,67,1352.91,1,5,2,8,Loyal Customers
3346,17205.0,53,13,384.08,1,2,1,4,Lost Customers
3347,17206.0,52,7,204.24,1,2,1,4,Lost Customers
3348,17211.0,26,213,2299.67,3,1,1,5,At Risk
3349,17212.0,252,4,226.85,1,5,2,8,Loyal Customers
3350,17213.0,39,164,2741.08,2,1,1,4,Lost Customers
3351,17214.0,59,104,984.12,1,2,1,4,Lost Customers
3352,17217.0,233,9,113.5,1,5,2,8,Loyal Customers
3353,17218.0,3,274,1960.72,5,1,1,7,Potential Loyalists
3354,17219.0,31,25,114.23,2,1,1,4,Lost Customers
3355,17220.0,23,472,3198.25,3,1,1,5,At Risk
3356,17221.0,6,63,335.13,5,1,1,7,Potential Loyalists
3357,17222.0,64,28,354.15,1,2,1,4,Lost Customers
3358,17223.0,309,48,391.79,1,5,3,9,Best Customers
3359,17226.0,308,21,393.49,1,5,3,9,Best Customers
3360,17227.0,18,47,939.32,3,1,1,5,At Risk
3361,17228.0,15,208,1906.09,3,1,1,5,At Risk
3362,17229.0,95,47,318.76,1,3,1,5,At Risk
3363,17230.0,263,73,3466.67,1,5,2,8,Loyal Customers
3364,17231.0,11,546,3127.82,4,1,1,6,Potential Loyalists
3365,17232.0,2,36,421.52,5,1,1,7,Potential Loyalists
3366,17233.0,34,25,190.88,2,1,1,4,Lost Customers
3367,17234.0,182,14,149.89,1,5,2,8,Loyal Customers
3368,17235.0,24,29,550.06,3,1,1,5,At Risk
3369,17236.0,12,105,916.13,4,1,1,6,Potential Loyalists
3370,17237.0,10,19,314.69,4,1,1,6,Potential Loyalists
3371,17238.0,2,566,3744.65,5,1,1,7,Potential Loyalists
3372,17239.0,312,16,379.95,1,5,3,9,Best Customers
3373,17242.0,107,40,1135.04,1,4,2,7,Potential Loyalists
3374,17243.0,0,406,8620.15,5,1,1,7,Potential Loyalists
3375,17244.0,52,31,954.9,1,2,1,4,Lost Customers
3376,17245.0,204,9,171.45,1,5,2,8,Loyal Customers
3377,17247.0,14,55,282.19,4,1,1,6,Potential Loyalists
3378,17248.0,119,69,318.65,1,4,2,7,Potential Loyalists
3379,17250.0,3,57,384.52,5,1,1,7,Potential Loyalists
3380,17251.0,362,39,283.28000000000003,1,5,3,9,Best Customers
3381,17252.0,116,87,353.86,1,4,2,7,Potential Loyalists
3382,17253.0,17,18,178.26,3,1,1,5,At Risk
3383,17254.0,4,112,272.44,5,1,1,7,Potential Loyalists
3384,17255.0,40,78,298.41,2,1,1,4,Lost Customers
3385,17256.0,106,16,240.0,1,4,2,7,Potential Loyalists
3386,17259.0,147,124,603.37,1,4,2,7,Potential Loyalists
3387,17262.0,51,12,1253.3600000000001,1,2,1,4,Lost Customers
3388,17263.0,207,23,63.440000000000005,1,5,2,8,Loyal Customers
3389,17265.0,138,127,562.9,1,4,2,7,Potential Loyalists
3390,17266.0,1,80,310.64,5,1,1,7,Potential Loyalists
3391,17267.0,126,38,317.62,1,4,2,7,Potential Loyalists
3392,17268.0,107,6,763.64,1,4,2,7,Potential Loyalists
3393,17272.0,41,116,2144.53,2,1,1,4,Lost Customers
3394,17274.0,34,27,111.98,2,1,1,4,Lost Customers
3395,17277.0,227,69,1065.3500000000001,1,5,2,8,Loyal Customers
3396,17278.0,240,15,246.04,1,5,2,8,Loyal Customers
3397,17279.0,57,9,187.82999999999998,1,2,1,4,Lost Customers
3398,17282.0,129,94,1703.41,1,4,2,7,Potential Loyalists
3399,17284.0,59,294,1641.68,1,2,1,4,Lost Customers
3400,17286.0,21,45,153.92,3,1,1,5,At Risk
3401,17287.0,25,124,1064.11,3,1,1,5,At Risk
3402,17288.0,8,142,1419.73,4,1,1,6,Potential Loyalists
3403,17289.0,31,112,936.16,2,1,1,4,Lost Customers
3404,17290.0,3,102,525.24,5,1,1,7,Potential Loyalists
3405,17291.0,307,1,550.8000000000001,1,5,3,9,Best Customers
3406,17293.0,7,135,1875.11,5,1,1,7,Potential Loyalists
3407,17295.0,28,69,556.95,3,1,1,5,At Risk
3408,17297.0,16,51,131.78,3,1,1,5,At Risk
3409,17298.0,100,30,498.42,1,3,2,6,Potential Loyalists
3410,17299.0,11,57,669.11,4,1,1,6,Potential Loyalists
3411,17301.0,20,66,197.63,3,1,1,5,At Risk
3412,17302.0,14,81,1119.93,4,1,1,6,Potential Loyalists
3413,17303.0,360,53,250.04,1,5,3,9,Best Customers
3414,17306.0,10,69,8600.73,4,1,1,6,Potential Loyalists
3416,17309.0,94,12,82.75,1,3,1,5,At Risk
3417,17311.0,77,55,1384.85,1,3,1,5,At Risk
3418,17312.0,138,14,644.3,1,4,2,7,Potential Loyalists
3419,17313.0,17,28,2288.13,3,1,1,5,At Risk
3420,17314.0,24,136,2514.76,3,1,1,5,At Risk
3421,17315.0,0,484,6164.38,5,1,1,7,Potential Loyalists
3422,17317.0,45,11,2524.02,2,2,1,5,At Risk
3423,17320.0,99,73,1200.6200000000001,1,3,1,5,At Risk
3424,17321.0,7,107,700.86,5,1,1,7,Potential Loyalists
3425,17323.0,14,203,905.59,4,1,1,6,Potential Loyalists
3426,17324.0,17,50,990.23,3,1,1,5,At Risk
3427,17325.0,279,6,96.8,1,5,2,8,Loyal Customers
3428,17329.0,13,33,523.11,4,1,1,6,Potential Loyalists
3429,17330.0,22,6,363.9,3,1,1,5,At Risk
3430,17331.0,123,1,175.2,1,4,2,7,Potential Loyalists
3431,17333.0,85,28,494.25,1,3,1,5,At Risk
3432,17334.0,300,12,306.6,1,5,3,9,Best Customers
3433,17337.0,150,547,1942.87,1,5,2,8,Loyal Customers
3434,17338.0,16,754,6606.34,3,1,1,5,At Risk
3435,17339.0,93,9,243.36,1,3,1,5,At Risk
3436,17340.0,8,423,12158.300000000001,4,1,1,6,Potential Loyalists
3437,17341.0,156,183,781.36,1,5,2,8,Loyal Customers
3438,17343.0,354,17,193.64,1,5,3,9,Best Customers
3439,17344.0,45,32,160.57,2,2,1,5,At Risk
3440,17345.0,14,87,537.74,4,1,1,6,Potential Loyalists
3441,17346.0,3,503,2611.58,5,1,1,7,Potential Loyalists
3442,17347.0,85,1,228.96,1,3,1,5,At Risk
3443,17348.0,14,215,1159.52,4,1,1,6,Potential Loyalists
3444,17349.0,178,9,110.75,1,5,2,8,Loyal Customers
3445,17350.0,7,72,1256.19,5,1,1,7,Potential Loyalists
3446,17351.0,35,27,587.15,2,1,1,4,Lost Customers
3447,17353.0,128,8,1740.0,1,4,2,7,Potential Loyalists
3448,17354.0,50,16,1393.06,1,2,1,4,Lost Customers
3449,17356.0,311,19,178.22,1,5,3,9,Best Customers
3450,17357.0,23,45,388.14,3,1,1,5,At Risk
3451,17358.0,302,59,365.85,1,5,3,9,Best Customers
3452,17359.0,10,15,127.86,4,1,1,6,Potential Loyalists
3453,17360.0,16,132,585.79,3,1,1,5,At Risk
3454,17361.0,48,29,488.2,1,2,1,4,Lost Customers
3455,17362.0,238,35,312.23,1,5,2,8,Loyal Customers
3456,17364.0,0,414,4455.73,5,1,1,7,Potential Loyalists
3457,17365.0,12,467,4796.52,4,1,1,6,Potential Loyalists
3458,17367.0,237,34,168.4,1,5,2,8,Loyal Customers
3459,17368.0,22,128,1349.52,3,1,1,5,At Risk
3460,17370.0,72,33,446.18,1,2,1,4,Lost Customers
3461,17371.0,16,87,423.89,3,1,1,5,At Risk
3462,17372.0,40,253,1342.68,2,1,1,4,Lost Customers
3463,17373.0,39,57,646.92,2,1,1,4,Lost Customers
3464,17374.0,218,28,495.77,1,5,2,8,Loyal Customers
3465,17375.0,189,71,372.5,1,5,2,8,Loyal Customers
3466,17376.0,70,24,203.2,1,2,1,4,Lost Customers
3467,17377.0,23,419,3925.92,3,1,1,5,At Risk
3468,17379.0,10,83,404.66,4,1,1,6,Potential Loyalists
3469,17381.0,8,110,20272.43,4,1,1,6,Potential Loyalists
3470,17382.0,64,2,65.4,1,2,1,4,Lost Customers
3471,17383.0,3,51,199.29,5,1,1,7,Potential Loyalists
3472,17384.0,18,15,336.4,3,1,1,5,At Risk
3473,17385.0,14,47,261.11,4,1,1,6,Potential Loyalists
3474,17386.0,7,28,2686.42,5,1,1,7,Potential Loyalists
3475,17387.0,19,78,784.11,3,1,1,5,At Risk
3476,17388.0,77,15,1259.56,1,3,1,5,At Risk
3477,17389.0,0,223,31317.48,5,1,1,7,Potential Loyalists
3478,17391.0,163,3,508.8,1,5,2,8,Loyal Customers
3479,17392.0,306,61,451.91,1,5,3,9,Best Customers
3480,17394.0,218,4,203.86999999999998,1,5,2,8,Loyal Customers
3481,17396.0,38,26,7312.8,2,1,1,4,Lost Customers
3482,17397.0,21,92,696.41,3,1,1,5,At Risk
3483,17398.0,114,38,653.38,1,4,2,7,Potential Loyalists
3484,17400.0,125,213,2129.96,1,4,2,7,Potential Loyalists
3485,17402.0,4,58,2598.85,5,1,1,7,Potential Loyalists
3486,17403.0,35,33,281.62,2,1,1,4,Lost Customers
3487,17405.0,0,94,967.22,5,1,1,7,Potential Loyalists
3488,17406.0,329,116,1928.72,1,5,3,9,Best Customers
3489,17408.0,162,2,32.65,1,5,2,8,Loyal Customers
3490,17409.0,184,13,771.85,1,5,2,8,Loyal Customers
3491,17410.0,15,64,1214.72,3,1,1,5,At Risk
3492,17411.0,11,43,748.94,4,1,1,6,Potential Loyalists
3493,17412.0,2,66,1258.06,5,1,1,7,Potential Loyalists
3494,17414.0,43,6,778.0,2,2,1,5,At Risk
3495,17415.0,79,14,507.84,1,3,1,5,At Risk
3496,17416.0,29,271,6838.34,3,1,1,5,At Risk
3497,17418.0,41,30,463.46000000000004,2,1,1,4,Lost Customers
3498,17419.0,10,208,4200.97,4,1,1,6,Potential Loyalists
3499,17420.0,49,30,598.83,1,2,1,4,Lost Customers
3500,17422.0,15,135,1853.1299999999999,3,1,1,5,At Risk
3501,17423.0,44,28,663.63,2,2,1,5,At Risk
3502,17425.0,18,43,759.17,3,1,1,5,At Risk
3503,17426.0,3,272,5022.26,5,1,1,7,Potential Loyalists
3504,17427.0,71,2,100.8,1,2,1,4,Lost Customers
3505,17428.0,0,343,17078.45,5,1,1,7,Potential Loyalists
3506,17429.0,120,42,512.12,1,4,2,7,Potential Loyalists
3507,17430.0,32,14,265.76,2,1,1,4,Lost Customers
3508,17431.0,312,43,403.3,1,5,3,9,Best Customers
3509,17432.0,17,48,365.76,3,1,1,5,At Risk
3510,17433.0,87,54,303.15999999999997,1,3,1,5,At Risk
3511,17434.0,1,138,2333.42,5,1,1,7,Potential Loyalists
3512,17436.0,1,9,216.3,5,1,1,7,Potential Loyalists
3513,17438.0,246,19,378.3,1,5,2,8,Loyal Customers
3514,17440.0,147,8,177.1,1,4,2,7,Potential Loyalists
3515,17442.0,28,140,2210.2599999999998,3,1,1,5,At Risk
3516,17446.0,176,9,120.89999999999999,1,5,2,8,Loyal Customers
3517,17447.0,39,36,541.53,2,1,1,4,Lost Customers
3518,17449.0,1,278,2501.86,5,1,1,7,Potential Loyalists
3519,17450.0,7,340,189735.53,5,1,1,7,Potential Loyalists
3520,17451.0,0,107,1648.95,5,1,1,7,Potential Loyalists
3521,17453.0,17,19,486.71999999999997,3,1,1,5,At Risk
3522,17454.0,191,61,517.53,1,5,2,8,Loyal Customers
3523,17455.0,203,8,131.7,1,5,2,8,Loyal Customers
3524,17456.0,364,17,249.86,1,5,3,9,Best Customers
3525,17457.0,126,19,1737.7,1,4,2,7,Potential Loyalists
3526,17458.0,14,54,316.5,4,1,1,6,Potential Loyalists
3527,17459.0,42,111,657.3,2,2,1,5,At Risk
3528,17460.0,78,37,452.63,1,3,1,5,At Risk
3529,17461.0,22,111,757.46,3,1,1,5,At Risk
3530,17462.0,50,28,662.94,1,2,1,4,Lost Customers
3531,17463.0,15,219,1881.36,3,1,1,5,At Risk
3532,17464.0,157,9,289.96000000000004,1,5,2,8,Loyal Customers
3533,17466.0,9,41,763.28,4,1,1,6,Potential Loyalists
3534,17468.0,9,5,137.0,4,1,1,6,Potential Loyalists
3535,17469.0,15,90,1843.06,3,1,1,5,At Risk
3536,17470.0,44,78,1125.07,2,2,1,5,At Risk
3537,17472.0,190,181,710.29,1,5,2,8,Loyal Customers
3538,17475.0,78,14,194.37,1,3,1,5,At Risk
3539,17480.0,73,31,506.51,1,2,1,4,Lost Customers
3540,17481.0,3,83,1249.34,5,1,1,7,Potential Loyalists
3541,17483.0,64,21,414.04,1,2,1,4,Lost Customers
3542,17486.0,260,24,396.87,1,5,2,8,Loyal Customers
3543,17489.0,58,29,376.64,1,2,1,4,Lost Customers
3544,17490.0,0,85,1936.83,5,1,1,7,Potential Loyalists
3545,17491.0,0,110,3541.92,5,1,1,7,Potential Loyalists
3546,17492.0,247,12,374.57,1,5,2,8,Loyal Customers
3547,17495.0,7,27,497.56,5,1,1,7,Potential Loyalists
3548,17496.0,358,10,271.05,1,5,3,9,Best Customers
3549,17498.0,75,17,272.21999999999997,1,3,1,5,At Risk
3550,17499.0,289,40,622.88,1,5,2,8,Loyal Customers
3551,17500.0,16,5,1138.0,3,1,1,5,At Risk
3552,17501.0,220,18,288.6,1,5,2,8,Loyal Customers
3553,17502.0,8,28,689.1,4,1,1,6,Potential Loyalists
3554,17503.0,2,38,558.96,5,1,1,7,Potential Loyalists
3555,17504.0,205,140,2745.28,1,5,2,8,Loyal Customers
3556,17505.0,161,52,1145.84,1,5,2,8,Loyal Customers
3557,17506.0,69,16,294.29,1,2,1,4,Lost Customers
3558,17507.0,261,88,605.58,1,5,2,8,Loyal Customers
3559,17509.0,57,369,6100.74,1,2,1,4,Lost Customers
3560,17510.0,24,20,308.48,3,1,1,5,At Risk
3561,17511.0,2,1074,88138.2,5,1,1,7,Potential Loyalists
3562,17512.0,28,106,2920.04,3,1,1,5,At Risk
3563,17513.0,71,6,513.2,1,2,1,4,Lost Customers
3564,17514.0,127,40,208.65,1,4,2,7,Potential Loyalists
3565,17515.0,30,87,639.02,3,1,1,5,At Risk
3566,17516.0,14,137,768.08,4,1,1,6,Potential Loyalists
3567,17517.0,308,11,153.94,1,5,3,9,Best Customers
3568,17519.0,16,83,1839.07,3,1,1,5,At Risk
3569,17520.0,53,30,546.81,1,2,1,4,Lost Customers
3570,17521.0,23,46,721.9599999999999,3,1,1,5,At Risk
3571,17522.0,1,72,1066.15,5,1,1,7,Potential Loyalists
3572,17523.0,10,33,652.74,4,1,1,6,Potential Loyalists
3573,17524.0,360,6,145.0,1,5,3,9,Best Customers
3574,17525.0,359,9,422.7,1,5,3,9,Best Customers
3575,17526.0,0,23,706.7,5,1,1,7,Potential Loyalists
3576,17527.0,53,49,888.86,1,2,1,4,Lost Customers
3577,17528.0,0,260,3540.1,5,1,1,7,Potential Loyalists
3578,17530.0,0,392,2380.41,5,1,1,7,Potential Loyalists
3579,17531.0,189,14,296.7,1,5,2,8,Loyal Customers
3580,17534.0,53,9,223.36,1,2,1,4,Lost Customers
3581,17535.0,279,13,164.4,1,5,2,8,Loyal Customers
3582,17536.0,176,3,76.5,1,5,2,8,Loyal Customers
3583,17537.0,29,75,897.62,3,1,1,5,At Risk
3584,17538.0,25,9,98.42,3,1,1,5,At Risk
3585,17540.0,8,26,570.4,4,1,1,6,Potential Loyalists
3586,17542.0,269,25,170.75,1,5,2,8,Loyal Customers
3587,17545.0,42,145,645.96,2,2,1,5,At Risk
3590,17549.0,23,6,148.86,3,1,1,5,At Risk
3591,17550.0,196,42,267.16,1,5,2,8,Loyal Customers
3592,17551.0,358,43,306.84,1,5,3,9,Best Customers
3593,17552.0,59,50,913.91,1,2,1,4,Lost Customers
3594,17553.0,129,2,1487.6,1,4,2,7,Potential Loyalists
3595,17554.0,0,88,1952.45,5,1,1,7,Potential Loyalists
3596,17555.0,19,106,483.26,3,1,1,5,At Risk
3597,17556.0,205,6,157.9,1,5,2,8,Loyal Customers
3598,17557.0,13,34,541.46,4,1,1,6,Potential Loyalists
3599,17560.0,94,27,854.95,1,3,1,5,At Risk
3600,17561.0,18,46,167.62,3,1,1,5,At Risk
3601,17562.0,13,64,1107.38,4,1,1,6,Potential Loyalists
3602,17564.0,23,49,454.01,3,1,1,5,At Risk
3603,17566.0,7,152,901.21,5,1,1,7,Potential Loyalists
3604,17567.0,6,177,4012.56,5,1,1,7,Potential Loyalists
3605,17569.0,331,29,344.14,1,5,3,9,Best Customers
3606,17571.0,49,298,1497.26,1,2,1,4,Lost Customers
3607,17572.0,70,12,226.75000000000003,1,2,1,4,Lost Customers
3608,17573.0,28,26,362.9,3,1,1,5,At Risk
3609,17574.0,242,8,185.65,1,5,2,8,Loyal Customers
3610,17576.0,7,417,3457.78,5,1,1,7,Potential Loyalists
3611,17578.0,190,6,124.74,1,5,2,8,Loyal Customers
3612,17579.0,4,52,440.2,5,1,1,7,Potential Loyalists
3613,17580.0,252,44,212.77,1,5,2,8,Loyal Customers
3614,17581.0,0,452,10736.11,5,1,1,7,Potential Loyalists
3615,17582.0,235,29,175.27,1,5,2,8,Loyal Customers
3616,17584.0,6,36,1227.3,5,1,1,7,Potential Loyalists
3617,17585.0,108,214,1133.07,1,4,2,7,Potential Loyalists
3618,17588.0,99,23,1240.2,1,3,1,5,At Risk
3619,17589.0,59,252,2402.92,1,2,1,4,Lost Customers
3620,17590.0,1,200,1477.97,5,1,1,7,Potential Loyalists
3621,17591.0,72,167,2215.02,1,2,1,4,Lost Customers
3622,17593.0,3,215,3911.56,5,1,1,7,Potential Loyalists
3623,17594.0,84,50,993.1800000000001,1,3,1,5,At Risk
3624,17595.0,11,83,388.79,4,1,1,6,Potential Loyalists
3625,17596.0,22,270,2827.93,3,1,1,5,At Risk
3626,17597.0,213,55,2044.3700000000001,1,5,2,8,Loyal Customers
3627,17600.0,17,13,161.67000000000002,3,1,1,5,At Risk
3628,17601.0,238,9,116.00999999999999,1,5,2,8,Loyal Customers
3629,17602.0,1,565,5050.77,5,1,1,7,Potential Loyalists
3630,17603.0,49,12,390.97,1,2,1,4,Lost Customers
3631,17604.0,216,63,309.36,1,5,2,8,Loyal Customers
3632,17608.0,32,59,193.42,2,1,1,4,Lost Customers
3633,17609.0,40,236,1096.42,2,1,1,4,Lost Customers
3634,17611.0,3,582,3947.87,5,1,1,7,Potential Loyalists
3635,17612.0,52,140,2000.32,1,2,1,4,Lost Customers
3636,17613.0,22,319,4509.37,3,1,1,5,At Risk
3637,17614.0,56,100,390.07,1,2,1,4,Lost Customers
3638,17615.0,129,14,329.6,1,4,2,7,Potential Loyalists
3639,17616.0,173,3,571.1999999999999,1,5,2,8,Loyal Customers
3640,17618.0,5,78,971.58,5,1,1,7,Potential Loyalists
3641,17619.0,311,77,218.52,1,5,3,9,Best Customers
3642,17620.0,59,4,81.44,1,2,1,4,Lost Customers
3643,17621.0,20,27,1336.1000000000001,3,1,1,5,At Risk
3644,17623.0,32,33,527.05,2,1,1,4,Lost Customers
3645,17624.0,14,50,843.48,4,1,1,6,Potential Loyalists
3646,17625.0,17,315,2047.0,3,1,1,5,At Risk
3647,17628.0,80,5,75.75,1,3,1,5,At Risk
3648,17629.0,5,124,1784.12,5,1,1,7,Potential Loyalists
3649,17630.0,169,26,503.59999999999997,1,5,2,8,Loyal Customers
3650,17631.0,1,39,528.33,5,1,1,7,Potential Loyalists
3651,17633.0,30,72,1242.34,3,1,1,5,At Risk
3652,17634.0,35,297,2361.97,2,1,1,4,Lost Customers
3653,17636.0,8,24,265.93,4,1,1,6,Potential Loyalists
3654,17637.0,30,35,547.0600000000001,3,1,1,5,At Risk
3655,17639.0,275,7,108.5,1,5,2,8,Loyal Customers
3656,17640.0,86,5,621.66,1,3,1,5,At Risk
3657,17642.0,119,40,712.29,1,4,2,7,Potential Loyalists
3658,17643.0,372,8,101.55,1,5,3,9,Best Customers
3659,17644.0,0,169,2768.98,5,1,1,7,Potential Loyalists
3660,17646.0,218,54,995.66,1,5,2,8,Loyal Customers
3661,17647.0,64,7,133.06,1,2,1,4,Lost Customers
3662,17648.0,60,92,1789.55,1,2,1,4,Lost Customers
3663,17649.0,134,53,861.74,1,4,2,7,Potential Loyalists
3664,17650.0,20,8,166.07999999999998,3,1,1,5,At Risk
3665,17651.0,11,239,3886.67,4,1,1,6,Potential Loyalists
3666,17652.0,24,270,4737.13,3,1,1,5,At Risk
3667,17653.0,28,50,1175.8799999999999,3,1,1,5,At Risk
3668,17654.0,276,22,117.55,1,5,2,8,Loyal Customers
3669,17655.0,10,93,2571.7400000000002,4,1,1,6,Potential Loyalists
3670,17656.0,72,82,1674.69,1,2,1,4,Lost Customers
3671,17658.0,10,23,485.88,4,1,1,6,Potential Loyalists
3672,17659.0,3,161,2954.75,5,1,1,7,Potential Loyalists
3673,17660.0,140,45,196.0,1,4,2,7,Potential Loyalists
3674,17663.0,25,90,1788.27,3,1,1,5,At Risk
3675,17664.0,18,43,604.64,3,1,1,5,At Risk
3676,17666.0,3,18,728.16,5,1,1,7,Potential Loyalists
3677,17667.0,65,117,2055.51,1,2,1,4,Lost Customers
3678,17668.0,0,15,347.75,5,1,1,7,Potential Loyalists
3679,17669.0,42,68,3406.7200000000003,2,2,1,5,At Risk
3680,17670.0,227,11,205.7,1,5,2,8,Loyal Customers
3681,17671.0,15,61,1284.08,3,1,1,5,At Risk
3682,17672.0,43,115,3106.62,2,2,1,5,At Risk
3683,17673.0,0,228,1622.22,5,1,1,7,Potential Loyalists
3684,17674.0,73,27,551.04,1,2,1,4,Lost Customers
3685,17675.0,0,721,20098.1,5,1,1,7,Potential Loyalists
3686,17676.0,3,78,1387.68,5,1,1,7,Potential Loyalists
3687,17677.0,1,321,16219.22,5,1,1,7,Potential Loyalists
3688,17678.0,263,16,298.11,1,5,2,8,Loyal Customers
3689,17679.0,52,30,1992.1100000000001,1,2,1,4,Lost Customers
3690,17680.0,23,11,184.4,3,1,1,5,At Risk
3691,17682.0,9,119,2459.33,4,1,1,6,Potential Loyalists
3692,17684.0,43,15,239.41,2,2,1,5,At Risk
3693,17685.0,16,130,3191.53,3,1,1,5,At Risk
3694,17686.0,6,286,5739.46,5,1,1,7,Potential Loyalists
3695,17690.0,29,258,4748.45,3,1,1,5,At Risk
3696,17691.0,357,19,290.40000000000003,1,5,3,9,Best Customers
3697,17692.0,126,46,718.08,1,4,2,7,Potential Loyalists
3698,17693.0,135,18,187.02,1,4,2,7,Potential Loyalists
3699,17694.0,141,15,283.12,1,4,2,7,Potential Loyalists
3700,17695.0,131,35,765.34,1,4,2,7,Potential Loyalists
3701,17696.0,37,126,2201.05,2,1,1,4,Lost Customers
3702,17697.0,235,19,338.95,1,5,2,8,Loyal Customers
3703,17698.0,260,8,154.95,1,5,2,8,Loyal Customers
3704,17700.0,16,146,2508.89,3,1,1,5,At Risk
3705,17701.0,252,24,417.95,1,5,2,8,Loyal Customers
3706,17702.0,29,80,1719.72,3,1,1,5,At Risk
3707,17703.0,34,55,798.74,2,1,1,4,Lost Customers
3708,17704.0,168,31,885.19,1,5,2,8,Loyal Customers
3709,17705.0,2,108,1781.12,5,1,1,7,Potential Loyalists
3710,17706.0,3,395,10097.37,5,1,1,7,Potential Loyalists
3711,17707.0,184,5,152.4,1,5,2,8,Loyal Customers
3712,17708.0,187,35,267.08,1,5,2,8,Loyal Customers
3713,17709.0,169,7,137.45,1,5,2,8,Loyal Customers
3714,17711.0,10,23,385.1,4,1,1,6,Potential Loyalists
3715,17712.0,44,29,522.91,2,2,1,5,At Risk
3716,17714.0,320,10,153.0,1,5,3,9,Best Customers
3717,17715.0,200,1,326.4,1,5,2,8,Loyal Customers
3718,17716.0,22,254,5505.79,3,1,1,5,At Risk
3719,17718.0,231,6,139.35,1,5,2,8,Loyal Customers
3720,17719.0,37,278,5367.8,2,1,1,4,Lost Customers
3721,17720.0,25,50,1195.94,3,1,1,5,At Risk
3722,17722.0,95,120,2380.64,1,3,1,5,At Risk
3723,17723.0,126,10,3276.4000000000005,1,4,2,7,Potential Loyalists
3724,17724.0,57,45,995.6500000000001,1,2,1,4,Lost Customers
3725,17725.0,15,198,3371.13,3,1,1,5,At Risk
3726,17727.0,8,67,1042.55,4,1,1,6,Potential Loyalists
3727,17728.0,3,168,2860.71,5,1,1,7,Potential Loyalists
3728,17730.0,2,220,5288.83,5,1,1,7,Potential Loyalists
3729,17731.0,78,83,878.2,1,3,1,5,At Risk
3730,17732.0,372,18,303.97,1,5,3,9,Best Customers
3731,17733.0,38,35,692.19,2,1,1,4,Lost Customers
3732,17734.0,53,43,700.63,1,2,1,4,Lost Customers
3733,17735.0,1,690,13110.02,5,1,1,7,Potential Loyalists
3734,17736.0,8,26,337.49,4,1,1,6,Potential Loyalists
3735,17737.0,8,10,168.24,4,1,1,6,Potential Loyalists
3736,17738.0,18,99,1863.35,3,1,1,5,At Risk
3737,17739.0,11,48,2786.05,4,1,1,6,Potential Loyalists
3738,17742.0,112,15,355.11,1,4,2,7,Potential Loyalists
3739,17744.0,3,136,2322.4,5,1,1,7,Potential Loyalists
3740,17746.0,234,8,98.8,1,5,2,8,Loyal Customers
3741,17747.0,99,2,64.65,1,3,1,5,At Risk
3742,17749.0,177,35,674.52,1,5,2,8,Loyal Customers
3743,17750.0,4,191,1781.28,5,1,1,7,Potential Loyalists
3744,17752.0,358,1,80.64,1,5,3,9,Best Customers
3745,17754.0,0,93,1739.92,5,1,1,7,Potential Loyalists
3746,17757.0,0,741,5581.54,5,1,1,7,Potential Loyalists
3747,17758.0,18,412,3456.7,3,1,1,5,At Risk
3748,17759.0,16,94,833.74,3,1,1,5,At Risk
3749,17760.0,21,25,287.59,3,1,1,5,At Risk
3750,17761.0,32,19,712.78,2,1,1,4,Lost Customers
3751,17763.0,262,1,15.0,1,5,2,8,Loyal Customers
3752,17764.0,50,75,818.8199999999999,1,2,1,4,Lost Customers
3753,17765.0,158,57,371.88,1,5,2,8,Loyal Customers
3754,17767.0,14,21,271.2,4,1,1,6,Potential Loyalists
3755,17768.0,7,105,2273.18,5,1,1,7,Potential Loyalists
3756,17769.0,12,313,3960.63,4,1,1,6,Potential Loyalists
3757,17770.0,198,38,1143.27,1,5,2,8,Loyal Customers
3758,17771.0,56,53,245.33,1,2,1,4,Lost Customers
3759,17772.0,10,53,182.77,4,1,1,6,Potential Loyalists
3760,17774.0,96,157,1215.46,1,3,1,5,At Risk
3761,17775.0,254,3,56.4,1,5,2,8,Loyal Customers
3762,17777.0,24,194,665.86,3,1,1,5,At Risk
3763,17779.0,20,84,642.17,3,1,1,5,At Risk
3764,17781.0,158,12,188.02,1,5,2,8,Loyal Customers
3765,17783.0,71,67,283.47,1,2,1,4,Lost Customers
3766,17785.0,52,13,131.94,1,2,1,4,Lost Customers
3767,17786.0,84,72,278.74,1,3,1,5,At Risk
3768,17787.0,152,134,1865.19,1,5,2,8,Loyal Customers
3769,17788.0,73,4,1112.95,1,2,1,4,Lost Customers
3770,17789.0,280,14,225.9,1,5,2,8,Loyal Customers
3771,17790.0,26,190,1965.55,3,1,1,5,At Risk
3772,17791.0,29,10,106.1,3,1,1,5,At Risk
3773,17793.0,24,58,323.04,3,1,1,5,At Risk
3774,17795.0,179,46,350.39,1,5,2,8,Loyal Customers
3775,17796.0,39,82,697.9,2,1,1,4,Lost Customers
3776,17797.0,21,111,780.43,3,1,1,5,At Risk
3777,17799.0,21,410,3026.08,3,1,1,5,At Risk
3778,17800.0,36,103,1198.01,2,1,1,4,Lost Customers
3779,17802.0,81,147,1251.84,1,3,1,5,At Risk
3780,17805.0,73,10,512.31,1,2,1,4,Lost Customers
3781,17806.0,10,43,546.04,4,1,1,6,Potential Loyalists
3782,17809.0,15,63,5344.85,3,1,1,5,At Risk
3783,17811.0,3,871,7671.01,5,1,1,7,Potential Loyalists
3784,17812.0,12,141,732.16,4,1,1,6,Potential Loyalists
3785,17813.0,13,378,1714.6,4,1,1,6,Potential Loyalists
3786,17816.0,36,17,36.56,2,1,1,4,Lost Customers
3787,17817.0,3,33,387.68,5,1,1,7,Potential Loyalists
3788,17819.0,71,49,3661.07,1,2,1,4,Lost Customers
3790,17824.0,50,13,298.4,1,2,1,4,Lost Customers
3791,17827.0,4,220,1995.46,5,1,1,7,Potential Loyalists
3792,17830.0,1,23,398.7,5,1,1,7,Potential Loyalists
3793,17831.0,32,2,35.400000000000006,2,1,1,4,Lost Customers
3794,17832.0,49,61,155.37,1,2,1,4,Lost Customers
3795,17835.0,2,61,350.64,5,1,1,7,Potential Loyalists
3796,17836.0,46,23,109.83,2,2,1,5,At Risk
3797,17837.0,41,171,1554.63,2,1,1,4,Lost Customers
3798,17838.0,26,137,2312.7,3,1,1,5,At Risk
3799,17839.0,41,56,338.8,2,1,1,4,Lost Customers
3800,17841.0,1,7971,40333.22,5,1,1,7,Potential Loyalists
3801,17843.0,302,35,197.73,1,5,3,9,Best Customers
3802,17848.0,80,51,901.1999999999999,1,3,1,5,At Risk
3803,17849.0,217,26,605.8000000000001,1,5,2,8,Loyal Customers
3804,17850.0,301,312,5288.63,1,5,3,9,Best Customers
3805,17852.0,11,24,114.34,4,1,1,6,Potential Loyalists
3806,17854.0,184,15,311.26,1,5,2,8,Loyal Customers
3807,17855.0,372,17,208.97,1,5,3,9,Best Customers
3808,17856.0,1,17,1393.79,5,1,1,7,Potential Loyalists
3809,17857.0,2,50,25185.84,5,1,1,7,Potential Loyalists
3810,17858.0,5,199,5155.66,5,1,1,7,Potential Loyalists
3811,17859.0,304,25,148.21,1,5,3,9,Best Customers
3812,17860.0,368,58,252.8,1,5,3,9,Best Customers
3813,17861.0,2,223,2059.2,5,1,1,7,Potential Loyalists
3814,17862.0,323,11,330.9,1,5,3,9,Best Customers
3815,17863.0,58,148,3160.0,1,2,1,4,Lost Customers
3816,17864.0,12,102,597.5,4,1,1,6,Potential Loyalists
3817,17865.0,30,388,10156.44,3,1,1,5,At Risk
3818,17866.0,142,10,325.7,1,4,2,7,Potential Loyalists
3819,17867.0,29,81,622.75,3,1,1,5,At Risk
3820,17869.0,106,40,428.18,1,4,2,7,Potential Loyalists
3821,17870.0,1,280,1889.4,5,1,1,7,Potential Loyalists
3822,17871.0,204,10,155.9,1,5,2,8,Loyal Customers
3823,17873.0,79,45,1634.98,1,3,1,5,At Risk
3824,17874.0,184,47,658.26,1,5,2,8,Loyal Customers
3825,17877.0,169,12,237.61,1,5,2,8,Loyal Customers
3826,17878.0,43,26,379.45,2,2,1,5,At Risk
3827,17879.0,173,6,178.52,1,5,2,8,Loyal Customers
3828,17880.0,364,26,458.92,1,5,3,9,Best Customers
3829,17881.0,303,8,133.35,1,5,3,9,Best Customers
3830,17883.0,2,145,671.77,5,1,1,7,Potential Loyalists
3831,17884.0,3,117,717.45,5,1,1,7,Potential Loyalists
3832,17885.0,11,64,190.19,4,1,1,6,Potential Loyalists
3833,17886.0,31,109,899.61,2,1,1,4,Lost Customers
3834,17887.0,128,10,111.35,1,4,2,7,Potential Loyalists
3835,17888.0,18,81,525.78,3,1,1,5,At Risk
3836,17889.0,211,21,203.87,1,5,2,8,Loyal Customers
3837,17890.0,322,94,602.09,1,5,3,9,Best Customers
3838,17891.0,161,34,203.85999999999999,1,5,2,8,Loyal Customers
3839,17892.0,55,28,244.1,1,2,1,4,Lost Customers
3840,17893.0,224,16,112.25,1,5,2,8,Loyal Customers
3841,17894.0,71,192,1119.39,1,2,1,4,Lost Customers
3842,17895.0,43,16,98.0,2,2,1,5,At Risk
3843,17896.0,22,2,256.32,3,1,1,5,At Risk
3844,17897.0,172,115,541.1,1,5,2,8,Loyal Customers
3845,17898.0,84,28,152.06,1,3,1,5,At Risk
3846,17899.0,158,32,155.8,1,5,2,8,Loyal Customers
3847,17900.0,164,11,15.0,1,5,2,8,Loyal Customers
3848,17901.0,28,19,110.38,3,1,1,5,At Risk
3849,17904.0,20,39,178.92000000000002,3,1,1,5,At Risk
3850,17905.0,70,34,800.24,1,2,1,4,Lost Customers
3851,17906.0,246,12,72.9,1,5,2,8,Loyal Customers
3852,17908.0,373,58,243.28,1,5,3,9,Best Customers
3853,17911.0,8,39,366.23,4,1,1,6,Potential Loyalists
3854,17912.0,309,40,295.61,1,5,3,9,Best Customers
3855,17913.0,58,59,411.6,1,2,1,4,Lost Customers
3856,17914.0,3,80,336.43,5,1,1,7,Potential Loyalists
3857,17917.0,44,94,341.28,2,2,1,5,At Risk
3858,17919.0,87,23,1304.04,1,3,1,5,At Risk
3859,17920.0,3,695,4192.2,5,1,1,7,Potential Loyalists
3860,17921.0,63,145,826.52,1,2,1,4,Lost Customers
3861,17923.0,281,1,207.50000000000003,1,5,2,8,Loyal Customers
3862,17924.0,0,38,2894.33,5,1,1,7,Potential Loyalists
3863,17925.0,372,1,244.08,1,5,3,9,Best Customers
3864,17926.0,132,21,397.29,1,4,2,7,Potential Loyalists
3865,17928.0,44,22,184.46,2,2,1,5,At Risk
3866,17929.0,10,6,834.5,4,1,1,6,Potential Loyalists
3867,17930.0,35,39,1740.48,2,1,1,4,Lost Customers
3868,17931.0,133,65,408.36,1,4,2,7,Potential Loyalists
3869,17932.0,28,90,1331.57,3,1,1,5,At Risk
3870,17934.0,51,21,704.25,1,2,1,4,Lost Customers
3871,17935.0,137,28,142.89000000000001,1,4,2,7,Potential Loyalists
3872,17936.0,4,77,389.84,5,1,1,7,Potential Loyalists
3873,17937.0,8,43,4301.22,4,1,1,6,Potential Loyalists
3874,17939.0,159,12,99.14,1,5,2,8,Loyal Customers
3875,17940.0,48,18,2238.58,1,2,1,4,Lost Customers
3876,17941.0,130,2,304.56,1,4,2,7,Potential Loyalists
3877,17942.0,7,2,77.50000000000001,5,1,1,7,Potential Loyalists
3878,17946.0,232,20,149.57999999999998,1,5,2,8,Loyal Customers
3879,17947.0,36,9,176.68,2,1,1,4,Lost Customers
3880,17948.0,146,1,358.56000000000006,1,4,2,7,Potential Loyalists
3881,17949.0,0,76,53215.74,5,1,1,7,Potential Loyalists
3882,17950.0,71,72,472.12,1,2,1,4,Lost Customers
3883,17951.0,39,21,990.8400000000001,2,1,1,4,Lost Customers
3884,17954.0,4,489,2295.37,5,1,1,7,Potential Loyalists
3885,17955.0,198,19,557.3,1,5,2,8,Loyal Customers
3886,17956.0,248,1,12.75,1,5,2,8,Loyal Customers
3887,17957.0,65,30,110.72,1,2,1,4,Lost Customers
3888,17958.0,116,7,508.4599999999999,1,4,2,7,Potential Loyalists
3889,17960.0,170,26,73.78,1,5,2,8,Loyal Customers
3890,17961.0,20,249,1296.44,3,1,1,5,At Risk
3891,17962.0,141,35,102.83,1,4,2,7,Potential Loyalists
3892,17964.0,31,104,471.7,2,1,1,4,Lost Customers
3893,17965.0,37,329,2622.57,2,1,1,4,Lost Customers
3894,17966.0,37,68,1098.43,2,1,1,4,Lost Customers
3895,17967.0,371,48,123.07,1,5,3,9,Best Customers
3896,17968.0,373,85,277.35,1,5,3,9,Best Customers
3897,17969.0,165,14,228.2,1,5,2,8,Loyal Customers
3898,17970.0,210,31,582.59,1,5,2,8,Loyal Customers
3899,17972.0,241,31,136.04,1,5,2,8,Loyal Customers
3900,17973.0,51,15,337.04,1,2,1,4,Lost Customers
3901,17974.0,24,179,740.79,3,1,1,5,At Risk
3902,17975.0,14,296,4390.31,4,1,1,6,Potential Loyalists
3903,17976.0,371,65,353.19,1,5,3,9,Best Customers
3904,17977.0,28,21,288.14,3,1,1,5,At Risk
3905,17978.0,364,12,300.91999999999996,1,5,3,9,Best Customers
3906,17979.0,35,146,734.41,2,1,1,4,Lost Customers
3907,17980.0,165,30,811.45,1,5,2,8,Loyal Customers
3908,17984.0,144,48,152.68,1,4,2,7,Potential Loyalists
3909,17985.0,21,23,634.95,3,1,1,5,At Risk
3910,17986.0,55,1,20.8,1,2,1,4,Lost Customers
3911,17987.0,184,13,198.57,1,5,2,8,Loyal Customers
3912,17988.0,11,39,191.17000000000002,4,1,1,6,Potential Loyalists
3913,17990.0,236,29,630.84,1,5,2,8,Loyal Customers
3914,17991.0,224,5,93.35,1,5,2,8,Loyal Customers
3915,17994.0,121,84,629.69,1,4,2,7,Potential Loyalists
3916,17995.0,281,2,76.1,1,5,2,8,Loyal Customers
3917,17997.0,73,178,1528.68,1,2,1,4,Lost Customers
3918,17999.0,36,93,382.06,2,1,1,4,Lost Customers
3919,18001.0,11,58,417.23,4,1,1,6,Potential Loyalists
3920,18004.0,361,40,169.47,1,5,3,9,Best Customers
3921,18005.0,3,60,249.72,5,1,1,7,Potential Loyalists
3922,18006.0,22,22,444.68,3,1,1,5,At Risk
3923,18008.0,69,30,2116.19,1,2,1,4,Lost Customers
3924,18009.0,234,33,252.24,1,5,2,8,Loyal Customers
3925,18010.0,256,14,174.8,1,5,2,8,Loyal Customers
3926,18011.0,372,28,102.78999999999999,1,5,3,9,Best Customers
3927,18013.0,154,31,187.29,1,5,2,8,Loyal Customers
3928,18014.0,27,31,158.47,3,1,1,5,At Risk
3929,18015.0,3,46,120.03,5,1,1,7,Potential Loyalists
3930,18016.0,31,123,1483.56,2,1,1,4,Lost Customers
3931,18017.0,80,3,523.0,1,3,1,5,At Risk
3932,18018.0,107,29,122.14,1,4,2,7,Potential Loyalists
3933,18019.0,51,5,38.45,1,2,1,4,Lost Customers
3934,18022.0,35,191,668.11,2,1,1,4,Lost Customers
3935,18024.0,152,22,236.77999999999997,1,5,2,8,Loyal Customers
3936,18027.0,98,21,115.31,1,3,1,5,At Risk
3937,18030.0,3,10,220.7,5,1,1,7,Potential Loyalists
3938,18032.0,333,5,73.5,1,5,3,9,Best Customers
3939,18033.0,64,34,97.97,1,2,1,4,Lost Customers
3940,18034.0,21,112,422.88,3,1,1,5,At Risk
3941,18035.0,35,53,730.4,2,1,1,4,Lost Customers
3942,18036.0,31,96,405.62,2,1,1,4,Lost Customers
3943,18037.0,153,19,70.02,1,5,2,8,Loyal Customers
3944,18040.0,18,19,357.20000000000005,3,1,1,5,At Risk
3945,18041.0,11,474,4161.14,4,1,1,6,Potential Loyalists
3946,18042.0,53,7,165.04999999999998,1,2,1,4,Lost Customers
3947,18043.0,24,121,559.51,3,1,1,5,At Risk
3948,18044.0,3,128,2085.65,5,1,1,7,Potential Loyalists
3949,18045.0,44,47,189.4,2,2,1,5,At Risk
3950,18048.0,202,7,172.29000000000002,1,5,2,8,Loyal Customers
3951,18050.0,358,5,74.4,1,5,3,9,Best Customers
3952,18053.0,65,21,297.07,1,2,1,4,Lost Customers
3953,18055.0,6,363,6752.14,5,1,1,7,Potential Loyalists
3954,18056.0,287,19,363.65,1,5,2,8,Loyal Customers
3955,18058.0,9,3,170.16,4,1,1,6,Potential Loyalists
3956,18059.0,8,21,296.71,4,1,1,6,Potential Loyalists
3957,18061.0,21,46,2119.41,3,1,1,5,At Risk
3958,18062.0,172,27,720.52,1,5,2,8,Loyal Customers
3959,18064.0,132,7,814.0,1,4,2,7,Potential Loyalists
3960,18065.0,5,138,2380.08,5,1,1,7,Potential Loyalists
3961,18066.0,74,10,318.0,1,2,1,4,Lost Customers
3962,18067.0,39,37,396.33,2,1,1,4,Lost Customers
3963,18068.0,288,1,101.7,1,5,2,8,Loyal Customers
3964,18069.0,25,472,2021.82,3,1,1,5,At Risk
3965,18071.0,257,25,453.0,1,5,2,8,Loyal Customers
3966,18072.0,154,34,12.239999999999995,1,5,2,8,Loyal Customers
3967,18073.0,113,76,3864.44,1,4,2,7,Potential Loyalists
3968,18074.0,373,13,489.6,1,5,3,9,Best Customers
3969,18075.0,22,153,2538.7200000000003,3,1,1,5,At Risk
3970,18077.0,7,227,2633.01,5,1,1,7,Potential Loyalists
3971,18078.0,216,29,336.13,1,5,2,8,Loyal Customers
3972,18079.0,44,127,3651.97,2,2,1,5,At Risk
3973,18080.0,18,2,1231.5,3,1,1,5,At Risk
3974,18081.0,35,17,343.45,2,1,1,4,Lost Customers
3975,18082.0,25,73,703.37,3,1,1,5,At Risk
3976,18084.0,15,2,87.53,3,1,1,5,At Risk
3977,18085.0,329,29,689.95,1,5,3,9,Best Customers
3978,18086.0,273,7,101.34,1,5,2,8,Loyal Customers
3979,18087.0,143,6,2917.3199999999993,1,4,2,7,Potential Loyalists
3980,18088.0,60,39,167.67000000000002,1,2,1,4,Lost Customers
3981,18092.0,1,90,9065.76,5,1,1,7,Potential Loyalists
3982,18093.0,92,38,2083.42,1,3,1,5,At Risk
3983,18094.0,81,70,3017.3,1,3,1,5,At Risk
3984,18095.0,312,21,580.05,1,5,3,9,Best Customers
3985,18096.0,11,213,911.15,4,1,1,6,Potential Loyalists
3986,18097.0,7,109,2692.85,5,1,1,7,Potential Loyalists
3987,18099.0,126,19,168.31,1,4,2,7,Potential Loyalists
3988,18101.0,10,41,223.65,4,1,1,6,Potential Loyalists
3989,18102.0,0,431,259657.3,5,1,1,7,Potential Loyalists
3990,18104.0,36,38,754.64,2,1,1,4,Lost Customers
3991,18105.0,37,18,113.48000000000002,2,1,1,4,Lost Customers
3992,18106.0,329,39,430.7,1,5,3,9,Best Customers
3993,18108.0,248,19,264.65,1,5,2,8,Loyal Customers
3994,18109.0,1,454,7925.32,5,1,1,7,Potential Loyalists
3995,18110.0,18,49,206.05,3,1,1,5,At Risk
3996,18112.0,11,26,352.69,4,1,1,6,Potential Loyalists
3997,18113.0,368,1,76.32000000000001,1,5,3,9,Best Customers
3998,18114.0,289,28,220.1,1,5,2,8,Loyal Customers
3999,18116.0,67,377,1414.43,1,2,1,4,Lost Customers
4000,18117.0,25,73,319.46999999999997,3,1,1,5,At Risk
4001,18118.0,10,1283,5593.37,4,1,1,6,Potential Loyalists
4002,18119.0,367,30,181.12,1,5,3,9,Best Customers
4003,18120.0,213,17,111.15,1,5,2,8,Loyal Customers
4004,18121.0,148,32,673.1,1,4,2,7,Potential Loyalists
4005,18122.0,7,362,1824.99,5,1,1,7,Potential Loyalists
4006,18123.0,23,36,589.4399999999999,3,1,1,5,At Risk
4007,18125.0,29,197,1141.34,3,1,1,5,At Risk
4008,18126.0,60,55,204.49,1,2,1,4,Lost Customers
4009,18127.0,18,47,348.73,3,1,1,5,At Risk
4010,18129.0,242,14,112.55000000000001,1,5,2,8,Loyal Customers
4011,18130.0,8,71,1045.74,4,1,1,6,Potential Loyalists
4012,18133.0,211,1,931.5,1,5,2,8,Loyal Customers
4013,18135.0,28,20,681.91,3,1,1,5,At Risk
4014,18136.0,62,39,761.83,1,2,1,4,Lost Customers
4015,18138.0,294,8,152.65,1,5,2,8,Loyal Customers
4016,18139.0,17,159,8438.34,3,1,1,5,At Risk
4018,18142.0,150,18,1014.9,1,5,2,8,Loyal Customers
4019,18143.0,116,61,1000.16,1,4,2,7,Potential Loyalists
4020,18144.0,7,43,2888.75,5,1,1,7,Potential Loyalists
4021,18145.0,12,221,2861.5499999999997,4,1,1,6,Potential Loyalists
4022,18146.0,140,10,160.35,1,4,2,7,Potential Loyalists
4023,18147.0,45,7,179.34,2,2,1,5,At Risk
4024,18149.0,50,16,612.0799999999999,1,2,1,4,Lost Customers
4025,18150.0,31,37,566.58,2,1,1,4,Lost Customers
4026,18151.0,134,38,653.35,1,4,2,7,Potential Loyalists
4027,18154.0,2,21,399.19,5,1,1,7,Potential Loyalists
4028,18155.0,74,28,347.82,1,2,1,4,Lost Customers
4029,18156.0,12,140,734.94,4,1,1,6,Potential Loyalists
4030,18158.0,8,35,451.75,4,1,1,6,Potential Loyalists
4031,18159.0,300,23,530.15,1,5,3,9,Best Customers
4032,18160.0,56,39,638.0600000000001,1,2,1,4,Lost Customers
4033,18161.0,9,81,1612.79,4,1,1,6,Potential Loyalists
4034,18164.0,30,25,394.7,3,1,1,5,At Risk
4035,18165.0,176,10,302.46,1,5,2,8,Loyal Customers
4036,18167.0,3,42,1361.51,5,1,1,7,Potential Loyalists
4037,18168.0,175,140,1133.64,1,5,2,8,Loyal Customers
4038,18169.0,60,9,202.65,1,2,1,4,Lost Customers
4039,18170.0,32,38,980.3100000000001,2,1,1,4,Lost Customers
4040,18171.0,58,56,1208.51,1,2,1,4,Lost Customers
4041,18172.0,14,197,7490.17,4,1,1,6,Potential Loyalists
4042,18173.0,86,31,2106.84,1,3,1,5,At Risk
4043,18174.0,6,1,104.0,5,1,1,7,Potential Loyalists
4044,18176.0,353,33,448.65,1,5,3,9,Best Customers
4045,18177.0,30,75,1314.17,3,1,1,5,At Risk
4046,18178.0,113,99,1573.41,1,4,2,7,Potential Loyalists
4047,18179.0,8,90,1793.17,4,1,1,6,Potential Loyalists
4048,18180.0,4,119,1843.75,5,1,1,7,Potential Loyalists
4049,18181.0,23,44,382.8,3,1,1,5,At Risk
4050,18183.0,217,44,600.52,1,5,2,8,Loyal Customers
4051,18184.0,14,1,49.8,4,1,1,6,Potential Loyalists
4052,18185.0,248,17,304.25,1,5,2,8,Loyal Customers
4053,18188.0,14,72,1998.49,4,1,1,6,Potential Loyalists
4054,18189.0,77,69,1084.34,1,3,1,5,At Risk
4055,18190.0,191,16,274.51,1,5,2,8,Loyal Customers
4056,18191.0,261,7,207.8,1,5,2,8,Loyal Customers
4057,18192.0,71,45,957.97,1,2,1,4,Lost Customers
4058,18193.0,150,18,212.96,1,5,2,8,Loyal Customers
4059,18194.0,63,9,896.0,1,2,1,4,Lost Customers
4060,18196.0,94,141,689.13,1,3,1,5,At Risk
4061,18198.0,3,166,5083.06,5,1,1,7,Potential Loyalists
4062,18200.0,105,32,163.8,1,4,2,7,Potential Loyalists
4063,18202.0,199,68,1396.99,1,5,2,8,Loyal Customers
4064,18203.0,156,19,160.42000000000002,1,5,2,8,Loyal Customers
4065,18204.0,70,202,1979.3,1,2,1,4,Lost Customers
4066,18205.0,35,32,517.36,2,1,1,4,Lost Customers
4067,18209.0,28,8,139.10000000000002,3,1,1,5,At Risk
4068,18210.0,1,134,2621.38,5,1,1,7,Potential Loyalists
4069,18211.0,25,42,600.07,3,1,1,5,At Risk
4070,18212.0,325,43,248.42,1,5,3,9,Best Customers
4071,18213.0,236,15,232.48000000000002,1,5,2,8,Loyal Customers
4072,18215.0,88,13,299.34000000000003,1,3,1,5,At Risk
4073,18216.0,30,26,481.75,3,1,1,5,At Risk
4074,18217.0,28,31,621.75,3,1,1,5,At Risk
4075,18218.0,205,24,626.38,1,5,2,8,Loyal Customers
4076,18219.0,2,115,2019.77,5,1,1,7,Potential Loyalists
4077,18220.0,219,4,297.78,1,5,2,8,Loyal Customers
4078,18221.0,21,65,1033.31,3,1,1,5,At Risk
4079,18222.0,92,19,443.0,1,3,1,5,At Risk
4080,18223.0,1,298,6318.070000000001,5,1,1,7,Potential Loyalists
4081,18224.0,263,10,158.95000000000002,1,5,2,8,Loyal Customers
4082,18225.0,2,286,5361.02,5,1,1,7,Potential Loyalists
4083,18226.0,38,245,5192.1,2,1,1,4,Lost Customers
4084,18227.0,217,5,93.75,1,5,2,8,Loyal Customers
4085,18228.0,49,32,769.2,1,2,1,4,Lost Customers
4086,18229.0,11,164,7276.9,4,1,1,6,Potential Loyalists
4087,18230.0,8,89,2716.6,4,1,1,6,Potential Loyalists
4088,18231.0,191,126,2066.17,1,5,2,8,Loyal Customers
4089,18232.0,81,40,582.47,1,3,1,5,At Risk
4090,18233.0,325,1,440.0,1,5,3,9,Best Customers
4091,18235.0,71,104,1796.48,1,2,1,4,Lost Customers
4092,18236.0,29,49,882.24,3,1,1,5,At Risk
4093,18237.0,2,61,987.1,5,1,1,7,Potential Loyalists
4094,18239.0,218,88,1561.6100000000001,1,5,2,8,Loyal Customers
4095,18240.0,45,6,422.58,2,2,1,5,At Risk
4096,18241.0,9,105,2058.09,4,1,1,6,Potential Loyalists
4097,18242.0,71,78,2232.4900000000002,1,2,1,4,Lost Customers
4098,18245.0,6,177,2507.56,5,1,1,7,Potential Loyalists
4099,18246.0,23,4,596.1,3,1,1,5,At Risk
4100,18248.0,113,49,783.02,1,4,2,7,Potential Loyalists
4101,18249.0,16,8,95.34,3,1,1,5,At Risk
4102,18250.0,300,22,342.92,1,5,3,9,Best Customers
4103,18251.0,86,16,4314.72,1,3,1,5,At Risk
4104,18252.0,50,98,526.67,1,2,1,4,Lost Customers
4105,18255.0,88,6,103.30000000000001,1,3,1,5,At Risk
4107,18257.0,38,122,2274.03,2,1,1,4,Lost Customers
4108,18259.0,24,42,2338.6,3,1,1,5,At Risk
4109,18260.0,172,140,2595.0,1,5,2,8,Loyal Customers
4110,18261.0,42,21,324.24,2,2,1,5,At Risk
4111,18262.0,139,13,149.48,1,4,2,7,Potential Loyalists
4112,18263.0,22,62,1211.08,3,1,1,5,At Risk
4113,18265.0,71,46,801.51,1,2,1,4,Lost Customers
4115,18269.0,357,8,138.9,1,5,3,9,Best Customers
4116,18270.0,37,12,244.9,2,1,1,4,Lost Customers
4117,18272.0,2,170,3064.78,5,1,1,7,Potential Loyalists
4118,18273.0,1,3,204.0,5,1,1,7,Potential Loyalists
4120,18276.0,20,16,323.36,3,1,1,5,At Risk
4121,18277.0,57,9,97.63,1,2,1,4,Lost Customers
4122,18278.0,73,9,173.9,1,2,1,4,Lost Customers
4123,18280.0,277,10,180.60000000000002,1,5,2,8,Loyal Customers
4124,18281.0,180,7,80.82,1,5,2,8,Loyal Customers
4125,18282.0,7,13,176.6,5,1,1,7,Potential Loyalists
4126,18283.0,3,754,2088.93,5,1,1,7,Potential Loyalists
4127,18287.0,42,70,1837.28,2,2,1,5,At Risk
